ATAC	RNA
AAAAAAAAATTGTCTACCCGCTGT	AAACAGCCAATCCTGA
AAAAAAAATTAAAGCACCTAAATG	AAACATGCATAATCCG
AAAAAAAACTGCACCACGATAAAG	AAACCAACAGGCATGA
AAAAAAAAACACCAAACGATAAAG	AAACCAACAGGTTATT
AAAAAAAAACCGGACACGATAAAG	AAACCAACATTAGGCC
AAAAAAAATGATCAGGAATAGTCA	AAACCGAAGAATCGCT
AAAAAAAACGATTGAGAATAGTCA	AAACCGAAGGTGAAAT
AAAAAAAACGTAATGGAATAGTCA	AAACCGAAGTTACTTC
AAAAAAAAACCATTATGAGCTATT	AAACCGCGTTTATCTG
AAAAAAAATTCGCGCACGGGTTAT	AAACGCGCAAACCTAT
AAAAAAAACGAGCTAACGGGTTAT	AAACGCGCATGACTAT
AAAAAAAATTACCCAACGGGTTAT	AAACGCGCATTATGAC
AAAAAAAATTACGTCACTAAGCGC	AAACGTACACAAAGAC
AAAAAAAACAGAGGGACTAAGCGC	AAACGTACAGTTAGCC
AAAAAAAATGCTTAGTGAGCCTGT	AAAGCAAGTCAACAAT
AAAAAAAACTTAAGAACTAACCCT	AAAGCACCATAATTGC
AAAAAAAACATAATGACTAACCCT	AAAGCACCATGGTTAT
AAAAAAAACAGCGCTTGGAAACTG	AAAGCCCGTGTAATAC
AAAAAAAATGAATTGACTCCCTCT	AAAGCCGCAATAATGG
AAAAAAAAATCCGGGACTCCCTCT	AAAGCCGCATCATGTG
AAAAAAAACTGACCGTGCTGAGGA	AAAGCTTGTAAAGCGG
AAAAAAAAGACATCCTGCTGAGGA	AAAGCTTGTCTAACAG
AAAAAAAAGAAGTCATGGCTAATT	AAAGGACGTCAAACTG
AAAAAAAACGTTAGGACACCGTTC	AAAGGAGCAAGCTTAT
AAAAAAAACCCAATTACACCGTTC	AAAGGAGCACCATATG
AAAAAAAAAGACCATACCTAATCC	AAAGGCTCAGCTAACC
AAAAAAAAACTTAGGACCTAATCC	AAAGGCTCATCATGGC
AAAAAAAACACATAAACCTAATCC	AAAGGCTCATGAATCT
AAAAAAAATGTAATGACCTAATCC	AAAGGCTCATTAAAGG
AAAAAAAACAGTTATCTAAGAATC	AAATGCCTCTAAGGAG
AAAAAAAACATGAGCACTTACCTG	AAATGGCCAACTGGGA
AAAAAAAAGCGCACAACTTACCTG	AAATGGCCATCAGCAC
AAAAAAAAAGGGACCTGCACACTA	AACAAAGGTAACGAGG
AAAAAAAAAGGCTGGTGCACACTA	AACAAAGGTCATAACG
AAAAAAAACTCACAATGCACACTA	AACAAAGGTGTTCCCA
AAAAAAAAGCCAGGATGCACACTA	AACAAAGGTTATCGAG
AAAAAAAAGGAGCAAACGTAGTTG	AACAAGCCACAGGATG
AAAAAAAACTATATCGAAGGTGCT	AACAGATAGCGAGCGA
AAAAAAAACGAACTAGAAGGTGCT	AACAGATAGGAGCACG
AAAAAAAAGCTCATTGAAGGTGCT	AACAGATAGGTAGCTT
AAAAAAAATAGACCAGAGTGTGAC	AACAGCAAGCCTTAAA
AAAAAAAAAATGAGGGAGTGTGAC	AACAGCAAGTAGCCAT
AAAAAAAAGGCATGACTATGAGGC	AACAGGATCCAGGTTG
AAAAAAAATGCGTGTCTATGAGGC	AACAGGATCCTGGTGA
AAAAAAAATCCAATACTATGAGGC	AACAGGATCTAATCAG
AAAAAAAATTCGTAACTATGAGGC	AACAGGATCTATGACA
AAAAAAAATGCCTCGACACTTGTT	AACATAGCAATAACCT
AAAAAAAATTGCAGGACACTTGTT	AACATAGCAATTGAGA
AAAAAAAAAGCTGTAACACTTGTT	AACATAGCACGTTACA
AAAAAAAAAGAATGAACACTTGTT	AACATAGCAGGCTGTT
AAAAAAAAGAAAGCCCTGCGCGTT	AACATCATCAGGATGA
AAAAAAAAAGGTGCACTGCGCGTT	AACATCATCAGGTTTA
AAAAAAAAGCCATGCCTGCGCGTT	AACATCATCTCACAAA
AAAAAAAAGTCGATTCTGTAATAG	AACATTGTCATTTGTC
AAAAAAAAGATTTAGGAGGTTACG	AACCCGCAGGAGCAAC
AAAAAAAAAATTGTGGAGGTTACG	AACCCGCAGGTCCAAT
AAAAAAAAGCTGATGGAGGTTACG	AACCCGCAGTCGCTAG
AAAAAAAAATACCGAACCAGTAGC	AACCGCTCACCAGCAT
AAAAAAAAAGCTTGAACCAGTAGC	AACCGCTCAGCTCATA
AAAAAAAACCGAAGTACCAGTAGC	AACCGCTCATGGCCCA
AAAAAAAATCTTGCTCTACTTAGC	AACCGGCTCAGTTCCC
AAAAAAAAACATAGTGAGATTAAC	AACCTTAAGACAGGCG
AAAAAAAAACGGATCGAGATTAAC	AACCTTAAGCCACAAT
AAAAAAAAGGAACCTGAGATTAAC	AACCTTAAGGATTGAG
AAAAAAAATCGGTTTACTTTGTGC	AACCTTGCACAGGGAC
AAAAAAAACTTAGAAACTTTGTGC	AACCTTGCAGCCTGCA
AAAAAAAAGGTGTTAACTTTGTGC	AACCTTGCAGGTTAAA
AAAAAAAACAGGATCACTTTGTGC	AACCTTGCATCTTGAG
AAAAAAAACGAGCTAACTTTGTGC	AACCTTGCATGACTAT
AAAAAAAACTGATTTGACACCTTG	AACGACAAGCTTTGTT
AAAAAAAACACAGCGGACACCTTG	AACGACAAGGCTGTGC
AAAAAAAATCTCAATGAAAGGCAA	AACGCCCAGGTCATTA
AAAAAAAAACGCCTCGAACCTACT	AACGGTAAGCTTAGCG
AAAAAAAAGTTCAAGACTGATGGC	AACTACTCACCGGTAT
AAAAAAAATGCCTTTCTCCTCGTC	AACTAGCTCGACAAAG
AAAAAAAAACCAATCCTCCTCGTC	AACTAGCTCGCTTCTA
AAAAAAAAACTCATGCTCCTCGTC	AACTAGCTCGTTTCTG
AAAAAAAACTTAGCTACCATACCT	AACTGTTCAAAGGTAC
AAAAAAAACTGTTACACCATACCT	AACTGTTCAACAGGTG
AAAAAAAACTATCGGCTGGCTAGA	AACTTAGTCAGGGCCT
AAAAAAAACCGGTTACTGGCTAGA	AACTTAGTCCGTTAAA
AAAAAAAATACTCCCTGCCCGTTT	AAGAACAGTCAATAGT
AAAAAAAAATACAGGTGCCCGTTT	AAGAACAGTCAATGTG
AAAAAAAATCCAGATTGCCCGTTT	AAGAACAGTTAAGCCA
AAAAAAAAAACCTAAGACGGATTA	AAGAATCAGAATCTCA
AAAAAAAAAAGTTTGGACGGATTA	AAGAATCAGCGGATTT
AAAAAAAAACAGCCTTGAAGCAAC	AAGACAAGTAGGATCC
AAAAAAAACCTGTAATGAAGCAAC	AAGACAAGTTTGCGCC
AAAAAAAATTTGTGTGACACCGTT	AAGACATAGCAAGATG
AAAAAAAACATAGGTGACACCGTT	AAGACATAGGCATGTT
AAAAAAAACCGCTTAGAATCCATC	AAGACCAAGTAAAGGT
AAAAAAAAAGTTGTCCTAAGGTCG	AAGCAAGTCAATTACG
AAAAAAAAAGCTTGTCTAAGGTCG	AAGCAAGTCATTCATC
AAAAAAAAGTGATGATGATTTGGT	AAGCCACGTAACCACA
AAAAAAAAGAGTCAATGATTTGGT	AAGCCACGTCACGGAT
AAAAAAAATACCTCCTGATTTGGT	AAGCCACGTTAGACCA
AAAAAAAATTACGGTTGATTTGGT	AAGCCACGTTGCAATG
AAAAAAAATACAACAACTAAAGCT	AAGCCTCCAACTAGCC
AAAAAAAAGGCCGATACTAAAGCT	AAGCCTCCAATTAACC
AAAAAAAATATGTCCACTAAAGCT	AAGCCTCCATAAGTTC
AAAAAAAATCCAGGAACTAAAGCT	AAGCCTCCATCACAGC
AAAAAAAACTTACGTACTAAAGCT	AAGCCTCCATCCGTAA
AAAAAAAACGACTTGCTTCCTTCA	AAGCCTGTCAAGTGTC
AAAAAAAACGTCCCTCTTCCTTCA	AAGCCTGTCTTACTCG
AAAAAAAAGTTTGTCGAATTAGCA	AAGCCTTAGAAAGCAT
AAAAAAAAAGAGCAAGAATTAGCA	AAGCCTTAGGAAGTAT
AAAAAAAATCCAGCACTTGCAACC	AAGCGAATCCTAACGG
AAAAAAAAAGTAATGCTTGCAACC	AAGCGAATCCTTCAAT
AAAAAAAACTTAGGCCTAACGGAC	AAGCGGGTCAATCTCT
AAAAAAAACAGGTTCCTAACGGAC	AAGCGGGTCACTTTAC
AAAAAAAATTAACACCTCCATCCC	AAGCGTTTCTTTAGGA
AAAAAAAACTATACTGATGTAACG	AAGCTAGAGTTGGATC
AAAAAAAATCGCTATACACTTACT	AAGCTCCCAATGAAGC
AAAAAAAAGAGGAACACACTTACT	AAGCTCCCACCACAAC
AAAAAAAAGAACTGATGTTTAGCG	AAGCTTGGTGATGATT
AAAAAAAAGATCATGACGTAATCG	AAGGATCCAAAGCTCC
AAAAAAAAAGTCAGTACGTAATCG	AAGGATCCATGAAATG
AAAAAAAAAGTAATGCTCTAAGGA	AAGGATGTCCTTCAAT
AAAAAAAATCCTTAAGAGTGACGT	AAGGATTAGCACAGAA
AAAAAAAATGTTCCTCTAACAGTA	AAGGCCCTCTGTTGCC
AAAAAAAATAAATCCCTAACAGTA	AAGGCCCTCTTGTCTG
AAAAAAAAACGGTGTGACATTGAG	AAGGTATAGCTCGCTT
AAAAAAAAGGTCATGGACATTGAG	AAGGTATAGGACTAAG
AAAAAAAACCTAGCTGACATTGAG	AAGGTATAGGCATGAA
AAAAAAAAGGTGAGGGACTTCGGT	AAGGTCAAGCGGGCAA
AAAAAAAACTAAAGCGACTTCGGT	AAGGTCAAGTGTGATC
AAAAAAAAGACTCAAACAACAAAG	AAGTAGCCAATTTGGT
AAAAAAAAAGGTTACACAACAAAG	AAGTAGCCATCAATCG
AAAAAAAAAGGCCCAACAACAAAG	AAGTAGCCATGCAACC
AAAAAAAATCCAATACTGACTTTG	AAGTCTATCTAATCAG
AAAAAAAACCCAGCATGGTTAGAG	AAGTGAAGTTAATGAC
AAAAAAAAAAACCATGATTTGCGC	AAGTGCAAGATAAAGC
AAAAAAAATCTGTGATGAGGCGCA	AAGTGTTGTTGACTTC
AAAAAAAAGCATATTTGTGAGCGA	AAGTTACGTAAACAAG
AAAAAAAAGCAAGTATGTGAGCGA	AAGTTACGTGTTGCTT
AAAAAAAAAGTCCTCACTCACAGG	AAGTTAGCAAGTGAAC
AAAAAAAAGATTTGGACTCACAGG	AAGTTAGCAATTAGCT
AAAAAAAAGATTGAGTGCGTGCGT	AATAACCGTACAATGT
AAAAAAAAGTTGCTGTGCGTGCGT	AATAACCGTATACTGG
AAAAAAAAGTTAGTTTGCGTGCGT	AATAACCGTTGAGGTC
AAAAAAAACAATCCATGGCCATCA	AATACCGGTCCAAATG
AAAAAAAATAATCCGTGGCCATCA	AATACCGGTTAACAGT
AAAAAAAACGGTATTTGTAATGGA	AATAGAGGTGAATCGC
AAAAAAAATGACAAATGTAATGGA	AATAGAGGTTTAACGG
AAAAAAAAGGATTGATGTAATGGA	AATAGAGGTTTACTTG
AAAAAAAATCGGTTATGTAATGGA	AATAGAGGTTTCAGGA
AAAAAAAAAGGAAGGTGTTCGGTA	AATAGCTGTAAATTGC
AAAAAAAACCTAGCGTGTTCGGTA	AATAGCTGTTAGGACC
AAAAAAAAACACCGTTGTTCGGTA	AATAGCTGTTATTGCC
AAAAAAAACCCGGTTACCGCCTAC	AATATCCCAGGCTTCG
AAAAAAAACCGAAGTACCGCCTAC	AATATCCCATGGCCCA
AAAAAAAAAACCTAAGAGACTCAG	AATCAGGAGAATCTCA
AAAAAAAACTTTAACGAGACTCAG	AATCAGGAGCTATATG
AAAAAAAATGAAGCCACTTAAGGT	AATCATCCAAGCTACC
AAAAAAAACAGGACTACTTAAGGT	AATCATCCAATTGAAG
AAAAAAAAGCAATTGACTTAAGGT	AATCATCCATTGACAT
AAAAAAAATGTGGACACTTAAGGT	AATCATCCATTGGGAG
AAAAAAAATTAGGAGCTAGGCGAT	AATCATGTCACGTTAA
AAAAAAAAATAAAGGACCTGATTC	AATCCATCACTAGGTC
AAAAAAAAGTCCGGAACCTGATTC	AATCCATCATGGCCTG
AAAAAAAATGACAACGATTCGCCA	AATCCGTAGTACCGCA
AAAAAAAACTATTGTGACTAGGCG	AATCCTAAGACTAAGG
AAAAAAAAGCTAACGGACTAGGCG	AATCCTAAGCTTAACA
AAAAAAAATGTGGACACAGCTATG	AATCGCCCATTGGGAG
AAAAAAAACGCTTTAACAGCTATG	AATCGCCCATTGTGTG
AAAAAAAACCATCACGACCCGGAA	AATCTCAAGCTACTGG
AAAAAAAAATGGATTGACCCGGAA	AATCTCAAGGCCCAGT
AAAAAAAACGGATTAGACCCGGAA	AATCTCAAGGTTACGT
AAAAAAAACTGGCTTGATTACGTT	AATCTTGAGATTGAGG
AAAAAAAATCAGTTTGATTACGTT	AATCTTGAGTTAGGCT
AAAAAAAACGGGATTACACTAAGC	AATGCAACACATAGCC
AAAAAAAATCCTAGTACACTAAGC	AATGCAACACTATGGC
AAAAAAAAGGGAACAACACTAAGC	AATGCAACACTCGCTC
AAAAAAAAGAGAGCAACACTAAGC	AATGCAACAGGACCTT
AAAAAAAAAGAATGAACACTAAGC	AATGCAACAGGCTGTT
AAAAAAAACGCAACCTGCTAGCTA	AATGCATGTAGCTGGT
AAAAAAAATCCCGGATGCTAGCTA	AATGCATGTAGTTAAC
AAAAAAAAGTCTAGCTGCTAGCTA	AATGCATGTGGATGTC
AAAAAAAAGCACGGTACTAACCGG	AATTACCCACGAATTT
AAAAAAAATGCACTTACTAACCGG	AATTACCCAGAGGCTA
AAAAAAAAGAGCGGTTGCAAGCTT	AATTAGCGTTAAGCGC
AAAAAAAACGAGGTTACGGTAACT	AATTCGTCACAACCTA
AAAAAAAACCAAGGTACGGTAACT	AATTCGTCACAGCCAT
AAAAAAAAGAGCCTGACGGTAACT	AATTCGTCAGGACACA
AAAAAAAAGGACTTAACGGTAACT	AATTCGTCATCCCTCA
AAAAAAAATGTAAGTACGGTAACT	AATTCGTCATTATGGT
AAAAAAAACGATTAAACGGTAACT	AATTCGTCATTGTCAG
AAAAAAAACGCTTTAACGGTAACT	AATTCGTCATTGTGTG
AAAAAAAAATGCTTATGCGGTAAG	AATTGACGTGCACGCA
AAAAAAAACCATGATTGCGGTAAG	AATTGACGTTCGCGCT
AAAAAAAACGAGTTAGACTGATCC	AATTGCCAGCACGATT
AAAAAAAAGGTACTAACATACCTT	AATTGCTCAGTCTAAT
AAAAAAAACACACCCACCAAACTA	AATTGGACACAATTAC
AAAAAAAAGCTACTCACCAAACTA	AATTGGACACTGACCG
AAAAAAAAGAACCTAACCAAACTA	AATTGGACAGCTTACA
AAAAAAAAGGCCTCACTCCTGAGT	AATTGTGTCATGCTTT
AAAAAAAATGCTGTTACCTTTACG	AATTTGCCAAGGATTA
AAAAAAAATTTACGCACCTTTACG	AATTTGCCAAGGTGCA
AAAAAAAATTGGTAAACCTTTACG	AATTTGCCACTAAATC
AAAAAAAATAACCTACTGCTACTA	AATTTGGTCCAGCACA
AAAAAAAAGAATTGACTGCTACTA	AATTTGGTCTCATCAT
AAAAAAAACTTGTAACTGCTACTA	AATTTGGTCTGCAAAC
AAAAAAAAGGCAATATGGTGCATC	ACAAACTGTAGGATTT
AAAAAAAATAGCGGATGGTGCATC	ACAAACTGTCAAGTGC
AAAAAAAACGATTACTGGTGCATC	ACAAACTGTGCTAGAC
AAAAAAAATGTGCACCTAAGCCAG	ACAAAGGTCGCTAAAC
AAAAAAAATTTAGTGCTAAGCCAG	ACAAAGGTCTAAGTCA
AAAAAAAATGGTCCACTAAGCCAG	ACAAAGGTCTTAGTGA
AAAAAAAACTTAACCACTGACATA	ACAACAACAATTAGGA
AAAAAAAAGCTCAGGACTGACATA	ACAACAACACTGGCCA
AAAAAAAACGTGAAACTGCAACCC	ACAACACTCAAGGACA
AAAAAAAACGCGAGTGATGCTTAT	ACAACAGAGAAAGGAA
AAAAAAAAGGGTTTCTGCTTGCCT	ACAACATGTGGTTCTT
AAAAAAAAGGGCGATTGATTCATG	ACACAATGTAGACAAA
AAAAAAAATTTATCCTGATTCATG	ACACAATGTCGCAAAC
AAAAAAAAGGCTTCATGATTCATG	ACACAATGTGTTGTGA
AAAAAAAACGCTAGCTGATTCATG	ACACAATGTTGGTTAG
AAAAAAAACTCCTACTGATTCATG	ACACAATGTTTGACCT
AAAAAAAAGAAAGCCCTAATGTGA	ACACTAATCAGGATGA
AAAAAAAACAACCTGCTAATGTGA	ACACTAATCGCGACAC
AAAAAAAACTTAGCGCTAATGTGA	ACACTAATCTCCTCAA
AAAAAAAAAATTAGGCTAATGTGA	ACACTAATCTTGGATA
AAAAAAAAGTTCCTTTGATGAAGC	ACACTAGGTGGTTATG
AAAAAAAAGTTAGCGGATTATTCG	ACACTTAAGCTTAGTA
AAAAAAAAACAACTAGATTATTCG	ACACTTAAGGAATAAC
AAAAAAAACATCGTTACCTCACTA	ACACTTGCAACATAAG
AAAAAAAATCACGTTACCTCACTA	ACACTTGCAATCCCTT
AAAAAAAATCCTGAATGTTGGCCG	ACAGCCGGTTATAGCG
AAAAAAAAAACTTGGACCAGCACA	ACAGGATCATGCTTAG
AAAAAAAACGTCAATTGGATTAGG	ACAGGCTGTAGCTAGC
AAAAAAAATTTGAGCTGGATTAGG	ACAGGCTGTCATCAAG
AAAAAAAATCTTTGTTGGATTAGG	ACAGGCTGTCTCAGCC
AAAAAAAATGGTCATTGGATTAGG	ACAGGCTGTGCTAGCG
AAAAAAAACCATAAGGATTAAGGC	ACAGGTAAGTTGGCCA
AAAAAAAACCTTGAGCTTCATCAA	ACATAGCTCATAATCG
AAAAAAAAGATGAATCTGTTTACG	ACATCAATCCTTGCGT
AAAAAAAATCAATGAACCCGGTAA	ACATCATCACAAGCCT
AAAAAAAATTACTGCACCCGGTAA	ACATCATCAGTATGTT
AAAAAAAAGCTATGTCTAGGTACG	ACATTAGTCTTTGAGA
AAAAAAAACACCACACTAACACCT	ACCAAACTCACCTGTC
AAAAAAAACTTTAGGTGTGGAGCA	ACCAAGCGTAAGCTTG
AAAAAAAAAAAGGTTCTACTCCCT	ACCAAGTTCGATCAGT
AAAAAAAATTTGCTCCTTAGTGCC	ACCAATATCATAGCCG
AAAAAAAACGGAGCACTTAGTGCC	ACCAATATCCTAGTAA
AAAAAAAACCTTCATCTTAGTGCC	ACCAATATCGTTAGCG
AAAAAAAATCCCACCCTTAGTGCC	ACCAATATCTGGCAAT
AAAAAAAACTGGGTAACTAGGATT	ACCACACCAAACTAAG
AAAAAAAATCAGCAAGAGGTAACC	ACCACATAGCAGCTCA
AAAAAAAACTAACGGACAGCACGC	ACCAGCTCAGGAACTG
AAAAAAAATGACAATACATTGCGA	ACCAGGACACCTCACC
AAAAAAAACCATTGTACATTGCGA	ACCAGGACATAAGGAC
AAAAAAAACTTAGGCCTCTTGACG	ACCAGGCTCAATCTCT
AAAAAAAATCTAAGTCTCTTGACG	ACCAGGCTCACTCGCT
AAAAAAAAGGAATATCTCTTGACG	ACCAGGCTCCAAACAC
AAAAAAAAATATAGCGATGACATG	ACCATTAAGTTAACCA
AAAAAAAACTGGTTATGTTGCGGC	ACCCAGGGTGCTGTAA
AAAAAAAATTCTATCTGTTGCGGC	ACCCAGGGTTGGGTTA
AAAAAAAAATGACAGTGTTGCGGC	ACCCAGGGTTTATGGG
AAAAAAAATGTTGCATGGGACAAT	ACCCGCTGTCAAAGGG
AAAAAAAACTACTAGTGGGACAAT	ACCCGCTGTCCAAGAC
AAAAAAAATCCCTGTTGGGACAAT	ACCCGCTGTGACATGC
AAAAAAAACTTCTATTGGGACAAT	ACCCGCTGTGAGCACT
AAAAAAAAAGCCTGTTGGGACAAT	ACCCGCTGTTAGTACG
AAAAAAAAGGAACAAGAATAATGC	ACCCGGTAGCACTTGG
AAAAAAAAGTACTGGGATTTGGAG	ACCCGTAAGTCTGGGC
AAAAAAAAGGCTAAGCTAACCAAA	ACCCTGTTCATCAGTA
AAAAAAAAGAATATGCTAACCAAA	ACCCTGTTCGGGCCAT
AAAAAAAAAGTCATCCTAACCAAA	ACCCTGTTCGTGCTAG
AAAAAAAAGCCTGTTACTCATGAA	ACCGAAGCAAACCCTA
AAAAAAAAGATTGCAACTCATGAA	ACCGAAGCAATTAAGG
AAAAAAAAAAGTAACCTGCAAGGT	ACCGCAATCTTGATGA
AAAAAAAACCATTACACGTGGCGT	ACCGGTTCATTGTGAT
AAAAAAAAAAGTTAGCTAGGAACC	ACCTAAATCAAACCGT
AAAAAAAAACGCGAACTAGGAACC	ACCTAAATCGAGGAGT
AAAAAAAAAGTGAGCCTAGGAACC	ACCTAAATCGGCCATA
AAAAAAAACGGGAACCTTGATGAG	ACCTACCTCAGCCAAT
AAAAAAAAGATGAATCTTGATGAG	ACCTACCTCCTTGCGT
AAAAAAAATGCATCGCTTGATGAG	ACCTACCTCGAGGAAC
AAAAAAAAATGTTGCCTAGTCCCG	ACCTCACTCCGTCCAT
AAAAAAAATTTAAGCCTCATAACT	ACCTGGATCTTGAGGT
AAAAAAAAACCCTCCTGGACGTAA	ACCTGTTGTGGAAACG
AAAAAAAACCATCCTTGGACGTAA	ACCTGTTGTTAGAGGG
AAAAAAAAGCTTGTGTGGACGTAA	ACCTGTTGTTGAAGCC
AAAAAAAAACAAGCGCTCACAGAA	ACCTTCATCAATAGCC
AAAAAAAATAGCAAGCTCACAGAA	ACCTTCATCATTAGGC
AAAAAAAATTCAGTACTCACAGAA	ACCTTCATCCCTGGTT
AAAAAAAAACCAGGTGAGTCATGG	ACCTTCCAGTTGTCAA
AAAAAAAAAGGGACCTGCTAGACT	ACCTTGTGTAACGAGG
AAAAAAAATGGCTTATGCTAGACT	ACCTTGTGTGCGCAAT
AAAAAAAAGGGAACCTGCTAGACT	ACCTTGTGTGGATTCA
AAAAAAAAACTGAGCGAGCGAATC	ACGAACAAGCTAAAGG
AAAAAAAAGATTTGGACTAGCCTT	ACGAAGTCAATTAGCT
AAAAAAAATTACTGCACTAGCCTT	ACGAAGTCAGTATGTT
AAAAAAAACATTAGTCTAAGTTCC	ACGAATCTCAATGACC
AAAAAAAACCATGCTGACCATGCT	ACGACAAAGTTCCCAC
AAAAAAAACTTTAACGAGTAATCA	ACGACTTAGCTATATG
AAAAAAAATGGCTAAGAGTAATCA	ACGACTTAGCTCCTAC
AAAAAAAACTATCGCGAGTAATCA	ACGACTTAGTCACTCC
AAAAAAAAGTACTTCGATAACCTT	ACGAGTAAGAGGATAT
AAAAAAAACACTAAGGATAACCTT	ACGAGTAAGTTCCTCA
AAAAAAAATAACTTCGATTTGCAT	ACGATTCAGCCTGGTA
AAAAAAAATCTTAGTGAATTTGGA	ACGCCACAGCAATAGG
AAAAAAAAGATTTGAGAATTTGGA	ACGCCACAGGGTCTAT
AAAAAAAACCATAAGGAATTTGGA	ACGCCACAGTTGGCCA
AAAAAAAAAACCTAAGATTCATGT	ACGCCTAAGAATCTCA
AAAAAAAATAGGTTGGATTCATGT	ACGCCTAAGGGCCACT
AAAAAAAATAGCCACCTGATTAGA	ACGCCTTTCGATTTGA
AAAAAAAAGGCAATATGTTTGCAG	ACGGGAAGTAGGATTT
AAAAAAAAGAAGTCATGTTTGCAG	ACGGGAAGTCAAACTG
AAAAAAAACGCCAACTGTTTGCAG	ACGGGAAGTCATTACC
AAAAAAAATCATTTCTGTTTGCAG	ACGGGAAGTCCTTTAA
AAAAAAAAACTAGTTTGTTTGCAG	ACGGGAAGTCTAACCT
AAAAAAAATTTATCCTGATTAGCT	ACGGTACGTCGCAAAC
AAAAAAAAAGGCTGGTGAAATGCG	ACGGTTAGTCATAACG
AAAAAAAACTGAAGGTGAAATGCG	ACGGTTAGTCCTAACT
AAAAAAAACAGATTCTGAAATGCG	ACGGTTAGTCTTGCAT
AAAAAAAATCGGTTATGAAATGCG	ACGGTTAGTTTCAGGA
AAAAAAAAAGCCAGGTGAAATGCG	ACGGTTAGTTTGCGAA
AAAAAAAACGATTAGGACAGGCTG	ACGGTTTAGCTTGCTC
AAAAAAAATAACCTTGACAGGCTG	ACGGTTTAGGAACCAA
AAAAAAAACGTGATGACAAGGTTC	ACGTACCCAATGAATG
AAAAAAAAACCCTCAACAAGGTTC	ACGTACCCAGCATTAT
AAAAAAAAAGGAAGGTGGTTAATC	ACGTCAAGTAAATTGC
AAAAAAAAGGGCGATTGGTTAATC	ACGTCAAGTAGACAAA
AAAAAAAAGTTCACTGAAGCCACA	ACGTCCAAGCATGAAG
AAAAAAAACTTGACCGAAGCCACA	ACGTCCAAGGCCATCA
AAAAAAAAACATAACGAGCTAGGT	ACGTTACAGAACCTGT
AAAAAAAAGCTATGGGATTATGGG	ACGTTGTAGTAGCTTA
AAAAAAAACGACTTATGTTGAGTC	ACTAACGGTCCTTCAG
AAAAAAAACGGTATTTGTTGAGTC	ACTAACGGTGAATCGC
AAAAAAAATCCGTAATGTTGAGTC	ACTAACGGTTCACCAT
AAAAAAAATGGTGTGACGTACCTC	ACTAACTCACAAAGGT
AAAAAAAAACTTAGGACGTACCTC	ACTAACTCATCATGGC
AAAAAAAAAGGATAAACGTACCTC	ACTAACTCATGTTTGG
AAAAAAAACTGCACCACATTAGCG	ACTAATCCAGGCATGA
AAAAAAAAGGAGGCTTGGGCGTGA	ACTAGGCGTTCAAGCA
AAAAAAAACAGATAATGCCGGAAA	ACTATCCGTAGGTTAT
AAAAAAAAGGTATAGTGCCGGAAA	ACTATCCGTGTTGTAG
AAAAAAAAAGTCACAACTAACGAT	ACTATGTCAAATATCC
AAAAAAAACCGTTGCACTAACGAT	ACTATGTCACGGTACT
AAAAAAAATGATTAGACTAACGAT	ACTATGTCAGCAAGTG
AAAAAAAACCAGAAACTAACCCTA	ACTCACCTCCTAAGTA
AAAAAAAACGGCTATCTAACCCTA	ACTCACCTCCTCCATA
AAAAAAAAGTTGCATCTAACCCTA	ACTCACCTCTAAGGTC
AAAAAAAACTGGTTATGAGAACCA	ACTCACTGTGCTGTAA
AAAAAAAACAGCGCTTGAGAACCA	ACTCACTGTGTAATAC
AAAAAAAATAGACAATGAGAACCA	ACTCACTGTTAAATGC
AAAAAAAAATTGGGATGAGAACCA	ACTCACTGTTGCGGAT
AAAAAAAAATTGCTCGATATCCTA	ACTCAGTAGCCATCAG
AAAAAAAAGACTAATGATATCCTA	ACTCAGTAGGCTAAGA
AAAAAAAACGGATTAGATATCCTA	ACTCAGTAGGTTACGT
AAAAAAAACCCTCCTGAAGGCTTG	ACTCCTCAGACACCGC
AAAAAAAACACCAACCTATGGACG	ACTCGCTTCAATGTGC
AAAAAAAAGTTTAGCCTATGGACG	ACTCGCTTCCATCAGG
AAAAAAAATAGGATGCTATGGACG	ACTCGCTTCCTTAGGG
AAAAAAAAGTAAGCTACACGGTTA	ACTGAAACAACCTAAT
AAAAAAAAACGGTTCTGTCCTTTA	ACTGAATGTAGCTAAT
AAAAAAAACATGAAATGTCCTTTA	ACTGAATGTCGTAAAT
AAAAAAAACTACTGATGTCCTTTA	ACTGAATGTTACTTGC
AAAAAAAAAAGTTTGGATGAGAAA	ACTTACAAGCGGATTT
AAAAAAAACTGCTGTGATGAGAAA	ACTTACAAGGGATGAC
AAAAAAAACGTAATGGATGAGAAA	ACTTACAAGTTACTTC
AAAAAAAAGAAGCACCTACCTGCG	ACTTACTTCAAACCTA
AAAAAAAAACATTGCCTACCTGCG	ACTTACTTCAGAAACG
AAAAAAAACGCTATGCTACCTGCG	ACTTACTTCCACCTTA
AAAAAAAAACCAATCCTACCTGCG	ACTTACTTCGCTTCTA
AAAAAAAAGAGGCACTGTTAAGGA	ACTTAGGGTAAAGCAA
AAAAAAAAGTGCGAGTGTTAAGGA	ACTTAGGGTATTGAGT
AAAAAAAACTCCATAACACGCGCA	ACTTAGTCAAGATTCT
AAAAAAAAATCCGCTACACGCGCA	ACTTAGTCACCTACTT
AAAAAAAAATGACTCCTCCCTCAC	ACTTATCTCATAACGC
AAAAAAAATTTCGTCCTCCCTCAC	ACTTATCTCATGGCTG
AAAAAAAACTGGATCCTCCCTCAC	ACTTATCTCCTCATCA
AAAAAAAAAGCTTACCTCCCTCAC	ACTTATCTCCTTGTTG
AAAAAAAATATTAGCCTCCCTCAC	ACTTATCTCTATCGCC
AAAAAAAAGATAATCGAGGACTTG	ACTTATGAGTCACTAA
AAAAAAAATAGCCCTGAGGACTTG	ACTTATGAGTGAACCT
AAAAAAAACGCCTAACTATTAGGA	ACTTGAATCCCGCATT
AAAAAAAACTTAGCTACATACCGA	ACTTGCACAAAGGTAC
AAAAAAAACATAAGTACATACCGA	ACTTGCACAAATTCGT
AAAAAAAATGCCTCGACATACCGA	ACTTGCACAATAACCT
AAAAAAAATGGCGTAACATACCGA	ACTTGCACAGGTATTT
AAAAAAAAGATTACGACATACCGA	ACTTGCACATGTTGTG
AAAAAAAAACTGAATGAACAAGCC	ACTTGTAAGCTTCCCG
AAAAAAAAAAATTGCGAACAAGCC	ACTTGTAAGTTATCTC
AAAAAAAAGGGCATGTGACCTTGG	ACTTGTCGTTAGCAGC
AAAAAAAATGGGTAACTTTAGCAT	ACTTTGTTCACGCATG
AAAAAAAACTTGAATCTTTAGCAT	ACTTTGTTCCCGCAAA
AAAAAAAAGATTCACCTTTAGCAT	ACTTTGTTCCTCATGC
AAAAAAAACGTTGCACTTTAGCAT	ACTTTGTTCGTTACAA
AAAAAAAACTTGTAACTTTAGCAT	ACTTTGTTCTGCAAAC
AAAAAAAAGCTAGTAACCTCAGCC	AGAAACCCACCTAATG
AAAAAAAACCCGGTTACCTCAGCC	AGAAACCCAGGCTTCG
AAAAAAAAAGGCCCAACCTCAGCC	AGAAACCCATGCAACC
AAAAAAAAAGTTACAGAAGCTATA	AGAAACTAGCTAGAAG
AAAAAAAAGTTAGCGGAAGCTATA	AGAAACTAGCTTAGTA
AAAAAAAATGTGATGGAAGCTATA	AGAAACTAGGCAATAG
AAAAAAAACGCAACCTGCCTCATC	AGAACAAGTAGCTGGT
AAAAAAAAATTGTCATGCCTCATC	AGAACAAGTTACTAGG
AAAAAAAAGCTAACGGATAGATGC	AGAACCAAGCTTAACA
AAAAAAAACATGATGGATAGATGC	AGAACCAAGGCCTTAG
AAAAAAAAATTGTCTACTAGTCCT	AGAACCGCAATCCTGA
AAAAAAAACGCATCCACTAGTCCT	AGAACCGCAGTAGGAT
AAAAAAAATTAAGGTACTAGTCCT	AGAACCGCAGTAGGTG
AAAAAAAACGCCAACTGCATCACA	AGAAGGTGTCATTACC
AAAAAAAATCATTTCTGCATCACA	AGAAGGTGTCCTTTAA
AAAAAAAATTGGTTTGAGGCACAT	AGAATCGAGCCTAATA
AAAAAAAAATGGATTGAGGCACAT	AGAATCGAGGCCCAGT
AAAAAAAACCAGGCTTGACTTCGG	AGAATCTGTCATGCAA
AAAAAAAAGCTCCCTTGACTTCGG	AGAATCTGTCTCACTG
AAAAAAAAGGGTTAATGACTTCGG	AGAATCTGTTAGGTTG
AAAAAAAAGAAGTTTGAATATGGT	AGACAATAGCATGTTA
AAAAAAAAGATTTAGGAATATGGT	AGACAATAGGAGCAAC
AAAAAAAAGTAATGTGAATATGGT	AGACAATAGGAGGACT
AAAAAAAAGCATATAGAATATGGT	AGACAATAGGTCCTGA
AAAAAAAACTAAAGCGAATATGGT	AGACAATAGTGTGATC
AAAAAAAATCAATGAACCAAGTCG	AGACACGCACAAGCCT
AAAAAAAAGGAAGCAACCAAGTCG	AGACACGCACTAAGTT
AAAAAAAAGAAACCTACCAAGTCG	AGACACGCAGGCATCT
AAAAAAAATCCAGGAACCAAGTCG	AGACACGCATCACAGC
AAAAAAAAGCCTTAGTGTCCATCC	AGACCCGGTGATTTGG
AAAAAAAATAAGCCTTGTCCATCC	AGACCCGGTTCATTTG
AAAAAAAATTGTTGGTGCCTCACT	AGACTATGTAGGTTTG
AAAAAAAATCAACAAACTATCCTG	AGAGAAGCAAACTGTT
AAAAAAAACCAGCAAACTATCCTG	AGAGAAGCACCAGGTT
AAAAAAAAGAGAGCAACTATCCTG	AGAGAAGCAGGACCTT
AAAAAAAAGTTAGTAGAGCTGCAA	AGAGAGGAGAGGAGTC
AAAAAAAAGATTTAGGAAGTAATC	AGAGATTAGGAGCAAC
AAAAAAAATGAAGCCACATTGTTC	AGAGGAACAAGCTACC
AAAAAAAACCGGTTCACATTGTTC	AGAGGAACAGTAAGTA
AAAAAAAATATTGGCTGTTTGAGC	AGAGGATGTCACAGAC
AAAAAAAAAGGCAATTGTTCGGGC	AGATGAAGTCATTGTC
AAAAAAAACAGATTCTGTTCGGGC	AGATGAAGTCTTGCAT
AAAAAAAAGCATGAGCTTTAAGTC	AGATGCTTCCACCCTG
AAAAAAAATTGGACCCTTTAAGTC	AGATGCTTCCGGTTAG
AAAAAAAAGCATAATGAGATTATG	AGCAAATAGGATCACT
AAAAAAAAAGTACCGGAGATTATG	AGCAAATAGTATGTGC
AAAAAAAAGATAATCGAGATTATG	AGCAAATAGTCACTAA
AAAAAAAAATGCATAGAGGTTTGG	AGCAACAAGGACAACA
AAAAAAAAAGACTCAACTGGTCTT	AGCAATACAATGCCCG
AAAAAAAAGGGCGATTGTTGTTCT	AGCAATTGTAGACAAA
AAAAAAAACCACTAATGTTGTTCT	AGCAATTGTATTGTCC
AAAAAAAAATACAGGTGTTGTTCT	AGCAATTGTCAATGTG
AAAAAAAAAGCTAAGTGTTGTTCT	AGCAATTGTCCTTAGT
AAAAAAAATAAAGCATGTTGTTCT	AGCAATTGTGCTCCAC
AAAAAAAAAAGACAAACCTGGAAC	AGCACAGCATCCTAGA
AAAAAAAAATTAGTGGACTATGTT	AGCACTTAGGACCTTG
AAAAAAAACAGTTAGGACTATGTT	AGCACTTAGTAAGTGG
AAAAAAAAGCTAAATGATGACAAC	AGCAGGTAGATAACCC
AAAAAAAACACACCCACGCAAGCC	AGCATCCCACAATTAC
AAAAAAAACGTCAAGACCCTAAGG	AGCATTTCAACTGGCT
AAAAAAAAGTGGTTAACCCTAAGG	AGCATTTCACTCAACA
AAAAAAAACAACGGTACCCTAAGG	AGCATTTCAGCAGGTA
AAAAAAAAAGCCCTTACCCTAAGG	AGCATTTCATTCAGCA
AAAAAAAAATTCCTGGACAACTAG	AGCCGCTAGGTATTGC
AAAAAAAAGGCGATACTGTTAGCT	AGCCGGTTCATCCTAT
AAAAAAAAGATATAGCTGTTAGCT	AGCCGGTTCATTAGCA
AAAAAAAATCCAATACTGTTAGCT	AGCCGGTTCTAATCAG
AAAAAAAATGCTTAGTGGATGTAG	AGCCTAAGTCAACAAT
AAAAAAAAAGAATCACTGGCCACT	AGCCTAGTCCTCCCTC
AAAAAAAACTCAGGCTGCAGCAAG	AGCCTCCGTAATCCCT
AAAAAAAAGTCTAGCTGCAGCAAG	AGCCTCCGTGGATGTC
AAAAAAAAATGACAGTGCAGCAAG	AGCCTCCGTTTATGGG
AAAAAAAAGTACAATGAACAACAT	AGCGCCTAGATTCCTT
AAAAAAAATACTCGCGAACTGAGC	AGCGCTCAGCTGTCAG
AAAAAAAACCTAACCGAACTGAGC	AGCGCTCAGGACCTGC
AAAAAAAACCATGCTGAACTGAGC	AGCGCTCAGTTCCCAC
AAAAAAAATACAACAACTAAATCG	AGCGGACCAACTAGCC
AAAAAAAAAGGTTACACTAAATCG	AGCGGACCATCAATCG
AAAAAAAAGAGGGAGCTCACTCAG	AGCTAACTCATGCTCC
AAAAAAAAAGCAAGCCTCGATTAT	AGCTACGTCACCATTT
AAAAAAAATGAGTGACTCGATTAT	AGCTACGTCCTGGCTT
AAAAAAAAATAATGCGATCCAATT	AGCTACTAGCAAGACA
AAAAAAAATTCTTAGGATCCAATT	AGCTACTAGCTGGAAA
AAAAAAAAGCTTGAGGATCCAATT	AGCTACTAGGTCCTAG
AAAAAAAACGGATTAGATCCAATT	AGCTACTAGGTTACGT
AAAAAAAAACCAGGTGATCCAATT	AGCTACTAGTTGTCAA
AAAAAAAACTACTTCCTGGTTAAA	AGCTAGTTCATTGCGG
AAAAAAAATATAACCCTGGTTAAA	AGCTAGTTCCTGAGTG
AAAAAAAAGGTCATTCTGGTTAAA	AGCTAGTTCGCTAGAT
AAAAAAAAGCAAATACTGGTTAAA	AGCTAGTTCTCGACCT
AAAAAAAATATGCGCCTTCATTGA	AGCTATATCAAGACTC
AAAAAAAATTGCATCACATACTGG	AGCTGCTCAAGTGTTT
AAAAAAAACTTCGTAACATACTGG	AGCTGCTCACAACAAA
AAAAAAAAGGCTTCGCTACTTCGA	AGCTTAATCCTAGTCC
AAAAAAAATGTGTTACTTGGACAA	AGCTTCCTCACAGCCA
AAAAAAAACGCTATGCTTGGACAA	AGCTTCCTCCACCTTA
AAAAAAAAGGCCTCACTGCGCCTA	AGCTTGGTCATGCTTT
AAAAAAAATTAGGTTCTGCGCCTA	AGCTTGGTCCTTCGTA
AAAAAAAATTATCACGAGAGGAAT	AGCTTTAAGCATTAGC
AAAAAAAAACCAAATGAGAGGAAT	AGCTTTAAGCTATTAG
AAAAAAAATAACTTCGAGAACCGT	AGGAACCAGCCTGGTA
AAAAAAAAGTCAAGCGATCCTGAC	AGGACGTAGACTTATG
AAAAAAAAGATAATCGATCCTGAC	AGGACGTAGTCACTAA
AAAAAAAAATTGCTCGATGTTGTT	AGGACTAAGCCATCAG
AAAAAAAATTGGTTTGATGTTGTT	AGGACTAAGCCTAATA
AAAAAAAACCTAGCTGATGTTGTT	AGGACTAAGGCATGAA
AAAAAAAACCTTTGGGATTACTGT	AGGATATAGAGAAGGG
AAAAAAAACGTTATGTGGACCTCA	AGGATCCGTAATCGTG
AAAAAAAAGTTGCTGTGGACCTCA	AGGATCCGTATACTGG
AAAAAAAAACTAACTTGGACCTCA	AGGATCCGTGTTAGCA
AAAAAAAAAACCTAAGATATTTGC	AGGATGCAGAATCTCA
AAAAAAAACCACTTAACGTATTTC	AGGATGTCACATTGCA
AAAAAAAAACCTGCTACGTATTTC	AGGATGTCATTGCGAC
AAAAAAAAAGGTTATGAAGCCATG	AGGATTGAGGACCGCT
AAAAAAAACCGCCTAACTGACCAG	AGGCAATCACTAAGCC
AAAAAAAAAGCTTGAACTGACCAG	AGGCAATCAGCTCATA
AAAAAAAACTAGTAAACTGACCAG	AGGCAATCAGTAAAGC
AAAAAAAAAAATACGCTTATTGCA	AGGCAGGTCTAACTGA
AAAAAAAAAGCCTTGTGTTGAGGG	AGGCCCAGTTGGTTCT
AAAAAAAAGGGTGAAACTAGCGAC	AGGCTAGCAATGCGCT
AAAAAAAACAGGACTACTAGCGAC	AGGCTAGCAATTGAAG
AAAAAAAAGATCCTACTTAAGGTG	AGGGCCTTCAATTGGC
AAAAAAAATTGAAGGCTTAAGGTG	AGGGCCTTCGCCTGTT
AAAAAAAAATCTGGAACGGGAACA	AGGGCTACAGGTTTGC
AAAAAAAATGTAATGACGGGAACA	AGGGCTACATTAAAGG
AAAAAAAAAACGGTTACCATAATG	AGGGTTGCAATGCCTA
AAAAAAAAGGTACTAACCATAATG	AGGGTTGCAGTCTAAT
AAAAAAAACCTAAGGACCATAATG	AGGGTTGCATTGTCCT
AAAAAAAACCATTACACCATAATG	AGGGTTGCATTGTGAT
AAAAAAAAACGCAATACTAGCGGT	AGGTAACCACAACAGG
AAAAAAAACCTGGAAACCTTGCAT	AGGTACGCAAAGCTAA
AAAAAAAATGCAGGATGTGGGAAC	AGGTATTGTTTCCTCC
AAAAAAAAAAGTGAGGAGGTGAGG	AGGTCAAAGACAAGTG
AAAAAAAACCCTCCTGAGGTGAGG	AGGTCAAAGACACCGC
AAAAAAAATGGTTAGGAGGTGAGG	AGGTCAAAGGAACCGG
AAAAAAAAGGATTTAGAGGTGAGG	AGGTCAAAGGAGGTTA
AAAAAAAAGTGATTAGAGGTGAGG	AGGTCAAAGGTCCGTA
AAAAAAAATCTAGCGCTAGCGAGT	AGGTCATTCGCGCTAA
AAAAAAAAGGCATGGTGGAAACGT	AGGTCCGGTCATAGAT
AAAAAAAATGGTTAGGATATTGGG	AGGTCTTAGGAACCGG
AAAAAAAACTCAGCACTGACCGCT	AGGTGAATCCGTTATT
AAAAAAAACGCAATCCTGACCGCT	AGGTGAATCGAAGTGA
AAAAAAAACAGTTATCTGACCGCT	AGGTGAATCTAAGGAG
AAAAAAAACCCTAAGCTGACCGCT	AGGTGAATCTCAATTC
AAAAAAAAAGGCTGGTGTAACCTG	AGGTGAGGTCATAACG
AAAAAAAACATGAGCACAAGCGTT	AGGTTAACAACTGGGA
AAAAAAAAGAAACCTACAAGCGTT	AGGTTAACAGGCATCT
AAAAAAAACCGTTAGCTAGGTAGC	AGGTTACTCACAAGCT
AAAAAAAACTAAGGACTAGGTAGC	AGGTTACTCATTATGG
AAAAAAAACGGCTATCTAGGTAGC	AGGTTACTCCTCCATA
AAAAAAAAGAGTTGCGAGGCAATC	AGGTTAGAGATGGAGC
AAAAAAAAGCTATACCTAGGTTCT	AGGTTTATCCTGTTCA
AAAAAAAAATTTGCGCTAGGTTCT	AGGTTTATCCTTTACG
AAAAAAAAGCAACGGTGAGTCATT	AGGTTTGGTATCTGGA
AAAAAAAAGCTCCCTTGAGTCATT	AGGTTTGGTCTCACTG
AAAAAAAACCTTACCTGAGTCATT	AGGTTTGGTTCATCTA
AAAAAAAAAAAGCTTGAGTCCCTG	AGTAAACAGGTACCGC
AAAAAAAACTAGTTTGAGTCCCTG	AGTAAACAGGTGCTGC
AAAAAAAATGGTGTGACTAATAGC	AGTAACACACAAAGGT
AAAAAAAAACCGCCACTCAATCTA	AGTAACCTCATGTGGT
AAAAAAAACGCGAGTGATCCGCAT	AGTAAGTAGAAAGGAA
AAAAAAAATAGGTTGGATCCGCAT	AGTAAGTAGGGCCACT
AAAAAAAAACGATTAGATCCGCAT	AGTAAGTAGTGAGCAA
AAAAAAAAGGTTACAACCTACCTA	AGTAATGCAATACTGT
AAAAAAAAGCTGAATACCTACCTA	AGTAATGCACAGAACG
AAAAAAAACCAGCAAACCTACCTA	AGTAATGCACCAGGTT
AAAAAAAACTTCATGACCTACCTA	AGTAATGCAGGCCTTG
AAAAAAAATGCAAGACTCACTGTG	AGTAGCTTCAACCAAC
AAAAAAAACGCCTCTCTCACTGTG	AGTAGCTTCAGGAACA
AAAAAAAATACCGCACTCACTGTG	AGTAGCTTCTTGTCCA
AAAAAAAACATTAGTCTATGTCCA	AGTAGGATCAATGACC
AAAAAAAAATATCGCCTATGTCCA	AGTAGGATCATAAGCC
AAAAAAAATTGACCGCTATGTCCA	AGTAGGATCATGGTGT
AAAAAAAAAACTTGGACACCATGA	AGTATAGCATGCTTAG
AAAAAAAAGAATCACACACCATGA	AGTATAGCATTGCGTA
AAAAAAAAACAACATGATCAGTAG	AGTCAAGAGAGAGGCT
AAAAAAAAAGGTTATGATCAGTAG	AGTCAAGAGGACCGCT
AAAAAAAATTCCCGTTGTTGGATC	AGTCAATGTAATCGCA
AAAAAAAACATGCTATGTTGGATC	AGTCAATGTGTAACCA
AAAAAAAACTACCGCACTCATAGA	AGTCAGGCATTTGCTC
AAAAAAAACGGCTCATGTTGCTCC	AGTCCTTGTAATAGCT
AAAAAAAATAATGCCTGTTGCTCC	AGTCCTTGTTATCCTA
AAAAAAAAGCGGTAACTTGCACAC	AGTCGCATCATGGTTA
AAAAAAAACAGTTTACTTGCACAC	AGTCGCATCCGCACAA
AAAAAAAAGGTATTGACCGGTTAG	AGTCTTGCACAAACTT
AAAAAAAATTTGGAAACCGGTTAG	AGTCTTGCACCAAAGG
AAAAAAAATTCGCGCACCAACAGC	AGTGAACCAAACCTAT
AAAAAAAATCGCTATACCAACAGC	AGTGAACCAATGAAGC
AAAAAAAATTAAGGTACCAACAGC	AGTGAACCAGTAGGTG
AAAAAAAAATGAGGAGAGCTAAGC	AGTGATGAGCATTATG
AAAAAAAATTTGCGCGAGCTAAGC	AGTGATGAGTCTCACC
AAAAAAAACCACTAATGTGATCCA	AGTGCACGTATTGTCC
AAAAAAAACCTTTATTGTGATCCA	AGTGCACGTCATCCTG
AAAAAAAAGGATTGATGTGATCCA	AGTGCACGTTTACTTG
AAAAAAAAGCTAAATGATCCAACC	AGTGGACAGATAACCC
AAAAAAAACCAACCTGATCCAACC	AGTGGACAGCCTGATG
AAAAAAAAAGTTACAGATCCAACC	AGTGGACAGCTAGAAG
AAAAAAAATCCTCCTACAAGGTAA	AGTGTTTCATAATCAC
AAAAAAAAACTTAGGACAAGGTAA	AGTGTTTCATCATGGC
AAAAAAAAAATCCACCTGGTCCAC	AGTTACATCCCGAAGC
AAAAAAAAGCCTAATCTGGTCCAC	AGTTACATCGTTAGTA
AAAAAAAAACCTTTAACCTGGATG	AGTTACTCAGATAGAC
AAAAAAAACACGGATACCTGGATG	AGTTACTCAGGAATCG
AAAAAAAACTATTGACTTACCGTG	AGTTATGTCCTAAGAC
AAAAAAAACTAGCCACTTACCGTG	AGTTATGTCCTGAATA
AAAAAAAAGCAAGTATGATCAATC	AGTTGCAGTGTTGCTT
AAAAAAAACCTTATTTGATCAATC	AGTTGCAGTTGTTCAC
AAAAAAAATGTAACCTGAGTGCGG	AGTTGGCGTTGCCTCA
AAAAAAAAGCTAACGGAGGAAGGC	AGTTGTCAGCTTAACA
AAAAAAAATCAAGGACTTCGTAAT	AGTTTGATCATAGACC
AAAAAAAAGATATAGCTTCGTAAT	AGTTTGATCATTAGCA
AAAAAAAAGATGAATCTTCGTAAT	AGTTTGATCCTTGCGT
AAAAAAAATGATCCTACAGGCGAA	ATAACGACACTGGCTG
AAAAAAAATACCCTTCTGAAACAT	ATAAGCCTCCTCCTAA
AAAAAAAACTTTACTTGAAGCCTC	ATAAGTCGTCCGGTTC
AAAAAAAATGTAACCTGAAGCCTC	ATAAGTCGTTGCCTCA
AAAAAAAAGGCCGATACCTGGTCC	ATAATGGCAATTAACC
AAAAAAAACAAGTCCCTGGTAAAT	ATACCGGTCGTTACTT
AAAAAAAACATAAGTACGAACAGG	ATACCTGCAAATTCGT
AAAAAAAAGTAATCGACGAACAGG	ATACCTGCAACAGCCT
AAAAAAAAGAGCCTGACGAACAGG	ATACCTGCAGGACACA
AAAAAAAATGGCATGACGAACAGG	ATACCTGCATAAGTCT
AAAAAAAACTTAGCTACAACTACG	ATAGATGCAAAGGTAC
AAAAAAAATCGCTATACAACTACG	ATAGATGCAATGAAGC
AAAAAAAACGGCCTTACAACTACG	ATAGATGCATAAGCAA
AAAAAAAAGCTTCTTTGTGCACCG	ATAGCATGTGAGACTC
AAAAAAAATGGTCATTGTGCACCG	ATAGCATGTGCTAGCG
AAAAAAAAGCACGGTACCTCAGGA	ATAGGTACACGAATTT
AAAAAAAAAACCATGACAAGTGGG	ATATAGGCAAACGCGA
AAAAAAAATAAATGCACAAGTGGG	ATATAGGCAGGCCATT
AAAAAAAACATGGTGACAAGTGGG	ATATAGGCATACCCGG
AAAAAAAATTGTTGACTTGAACAG	ATATGCATCTGGTCCT
AAAAAAAACTGAAGGTGTAGCCCG	ATATGGTGTCCTAACT
AAAAAAAAGGGTTTCTGTAGCCCG	ATATGGTGTGGTTCTT
AAAAAAAAGCACGGTACCTTAGTC	ATATGTCCACGAATTT
AAAAAAAAGCAATTGACCTTAGTC	ATATGTCCATTGACAT
AAAAAAAAGGAAGCAACAGGTGAG	ATCAAGACACTAAGTT
AAAAAAAACAATTTGCTGGTCATT	ATCAAGCTCTAACCTT
AAAAAAAAACCCGGAACCTTCTAG	ATCAATCCAACCCTAA
AAAAAAAATGAAGCCACCTTCTAG	ATCAATCCAAGCTACC
AAAAAAAACCCGGTTACCTTCTAG	ATCAATCCAGGCTTCG
AAAAAAAAGAAGCACCTCAAGGGC	ATCACAATCAAACCTA
AAAAAAAACCAGGTTCTCAAGGGC	ATCACAATCCTCGATC
AAAAAAAATGAGTGACTCAAGGGC	ATCACAATCCTGGCTT
AAAAAAAACCTAATTGAGGGAGGT	ATCACACAGCCGCAGT
AAAAAAAAAGGATTTGAGGGAGGT	ATCACACAGTTTGAGC
AAAAAAAACCGAAGCGAGGGAGGT	ATCACACAGTTTGGTA
AAAAAAAATTGAGGACTATGCTCA	ATCACCCTCAAACACC
AAAAAAAATAGGAGTCTATGCTCA	ATCACCCTCACTAATG
AAAAAAAAAGCTTACCTATGCTCA	ATCACCCTCCTTGTTG
AAAAAAAATCCTCTACTATGCTCA	ATCACCCTCGCACACA
AAAAAAAAGCAAATACTATGCTCA	ATCACCCTCTCGACCT
AAAAAAAATGTTGTTGAATTAGAC	ATCACTAAGACAACAG
AAAAAAAAGTTGAGCGAATTAGAC	ATCACTAAGGCACAGG
AAAAAAAATTGAAGCGAATTAGAC	ATCACTAAGTAACAGG
AAAAAAAAGATGAAGGAGTCGCAA	ATCATCAAGCCTGAGC
AAAAAAAAAGCAATTGAGTCGCAA	ATCATCAAGTCTATGA
AAAAAAAATTGGTAAACGGGTATT	ATCATGTCACTAAATC
AAAAAAAAATGGTCAACGGGTATT	ATCATGTCAGTCTATG
AAAAAAAAGCAATTGACGGGTATT	ATCATGTCATTGACAT
AAAAAAAAAAATGCTGAGGGTTAC	ATCCAACAGAGAGGAG
AAAAAAAAGTTAGCGGAGGGTTAC	ATCCAACAGCTTAGTA
AAAAAAAATTCAGTACTGATCACT	ATCCACCTCCCTGGTT
AAAAAAAACAACAAGCTGATCACT	ATCCACCTCCCTTGCG
AAAAAAAATACTGAGGAATCCGTT	ATCCATAAGCACAGCC
AAAAAAAAAGTATTGGAATCCGTT	ATCCATAAGCGTGCAC
AAAAAAAACAAATGCGAATCCGTT	ATCCATAAGCTGCACA
AAAAAAAATGTGATGGAATCCGTT	ATCCATAAGGCAATAG
AAAAAAAAGCGCAATGAATCCGTT	ATCCATAAGGGTGGAT
AAAAAAAAATCCGCATGCGGATCC	ATCCCGCGTACGATTG
AAAAAAAAGCAGTAATGCGGATCC	ATCCCGCGTATTGGAT
AAAAAAAAACCAATCCTGGACCCT	ATCCTCATCGCTTCTA
AAAAAAAATCAATTGCTGGACCCT	ATCCTCATCTCCATAT
AAAAAAAATCACCATACCGTTATC	ATCCTGACAAGACTCC
AAAAAAAAGATCAGTACCGTTATC	ATCCTGACATTAGCGC
AAAAAAAAAGTAGGTTGGTCCTGA	ATCCTTAGTCGCATAA
AAAAAAAACATGAAATGGTCCTGA	ATCCTTAGTCGTAAAT
AAAAAAAATAAAGCATGGTCCTGA	ATCCTTAGTGCTCCAC
AAAAAAAATCCTCCTACAACCTAG	ATCGAGGCATAATCAC
AAAAAAAATGGTTAAACAACCTAG	ATCGAGGCATCTAGCA
AAAAAAAATCTTTGTTGTTCTTAC	ATCGCCCGTCTCAGCC
AAAAAAAACGCACCATGGCCTGAT	ATCGCTTGTTGTGACA
AAAAAAAAACCCGCTGACAAGAAA	ATCTATGAGCAAGGTA
AAAAAAAACTTCTATTGCACGGTC	ATCTTTGGTGAGCACT
AAAAAAAAGGTTAATGATAAGCAC	ATGAAGTAGAACCTAC
AAAAAAAACTGGCTTGATAAGCAC	ATGAAGTAGATTGAGG
AAAAAAAACGAGGTTACCGACTCC	ATGAATGCACAACCTA
AAAAAAAAGGTACGCACCGACTCC	ATGAATGCACTTCACT
AAAAAAAAATCTGGAACCGACTCC	ATGAATGCAGGTTTGC
AAAAAAAAATGGAGGACGTTAAGC	ATGACAACAAACCTTG
AAAAAAAAAAACCGTACGTTAAGC	ATGACAACAGCCAGTT
AAAAAAAATCCGTAATGCCACAAT	ATGACCAGTTCACCAT
AAAAAAAAATCGTTATGCCACAAT	ATGACCAGTTTCGCCA
AAAAAAAAATATAGCGAACGAATT	ATGACGAAGTTAACCA
AAAAAAAAGATAGCCGATAGCCTC	ATGACTCAGCACGTTG
AAAAAAAAGACTAATGATAGCCTC	ATGACTCAGGCTAAGA
AAAAAAAAAACGATTGATAGCCTC	ATGACTCAGGTTAGAG
AAAAAAAATTACCTTTGTGTTCCC	ATGAGCCGTGTCCAGG
AAAAAAAAGCGGTCAACTAGGCTG	ATGATGACAACCGCCA
AAAAAAAACCCAATTACTAGGCTG	ATGATGACACCATATG
AAAAAAAAAGCTTGAACTAGGCTG	ATGATGACAGCTCATA
AAAAAAAAGTGTAATGAACAAAGG	ATGATGGAGGATTTGC
AAAAAAAATAGGTACGAACAAAGG	ATGATGGAGGTAAGCA
AAAAAAAATCCGTTAACTCGATAA	ATGCAAACAATAAGCA
AAAAAAAATCACGTTACTCGATAA	ATGCAAACAATCCCTT
AAAAAAAAGCGATTAACTCGATAA	ATGCAAACAGAACCGA
AAAAAAAATGTAATGACCTAACCT	ATGCAGGCATTAAAGG
AAAAAAAAGATCATGACTGACTTC	ATGCATTCAAAGCTCC
AAAAAAAAGCGGTTGACTGACTTC	ATGCATTCAAGGAATC
AAAAAAAAAACCACAACTGACTTC	ATGCATTCAAGGTCGA
AAAAAAAAGAAACTCACTGACTTC	ATGCATTCACCTCAGG
AAAAAAAACTGATTTGAAACACGC	ATGCCTGAGCTTTGTT
AAAAAAAAATAGCCGGAAACACGC	ATGCCTGAGGCCGGAA
AAAAAAAAGCGGTAACTTGCATTA	ATGCGATTCATGGTTA
AAAAAAAAGCCAACCCTTGCATTA	ATGCGATTCCATAATG
AAAAAAAAGGCTGATGAACTAATG	ATGCTTAAGACAGGTA
AAAAAAAAGCAATGCGAACTAATG	ATGCTTAAGAGGAAGG
AAAAAAAAAACTAACGAACTAATG	ATGCTTAAGTCACGAT
AAAAAAAACGATCCTGAACTAATG	ATGCTTAAGTGAGGTA
AAAAAAAAGTCAAGCGATTCATCA	ATGGACAAGACTTATG
AAAAAAAATCGTACCGATTCATCA	ATGGACAAGCCAAATC
AAAAAAAACAGCTAAGATTCATCA	ATGGACAAGGCCAATT
AAAAAAAAGCTATGGGATTCATCA	ATGGACAAGTAGCTTA
AAAAAAAAGGCTTAGGAGCTATGG	ATGGCCCAGACACTTA
AAAAAAAAGTACTTCGAGCTATGG	ATGGCCCAGAGGATAT
AAAAAAAAGCGAGAGGAGCTATGG	ATGGCCCAGGTTACAC
AAAAAAAAAATCACAGAGCTATGG	ATGGCCCAGTTATGGC
AAAAAAAAAGGAAGGTGAGAAGCT	ATGGCCGGTAAATTGC
AAAAAAAAGCTGGTTTGAGAAGCT	ATGGCCGGTACTGAAT
AAAAAAAAGTCCTGATGGATTGCC	ATGGCTAGTCACCTAT
AAAAAAAAATGCTTATGGATTGCC	ATGGCTAGTGCACGCA
AAAAAAAATGACAAATGGATTGCC	ATGGCTAGTTTAACGG
AAAAAAAATAACCTACTTCATGCG	ATGGCTGTCCAGCACA
AAAAAAAATCATGAGGATAAACCG	ATGGCTTAGTTTGTCT
AAAAAAAAACGCGTTTGAGTCTTA	ATGGTGCGTGAGAAAC
AAAAAAAAGATACTCCTATGTTGC	ATGGTTATCCGCAACA
AAAAAAAACATCATGTGCACCTTC	ATGTAACGTCAGGCCA
AAAAAAAAAACGGGAACTAGGCGT	ATGTAAGCAACTAACT
AAAAAAAATGCGTGAACTAGGCGT	ATGTAAGCACATTAAC
AAAAAAAATAAGGTTACTAGGCGT	ATGTAAGCACGAATCC
AAAAAAAATCCCATAACTAGGCGT	ATGTAAGCAGAAATGC
AAAAAAAATGCCAGAACTAGGCGT	ATGTAAGCAGCAACCT
AAAAAAAAACCCTCAACTAGGCGT	ATGTAAGCAGCATTAT
AAAAAAAAAAACCGTACTAGGCGT	ATGTAAGCAGCCAGTT
AAAAAAAATGTAATGACTAGGCGT	ATGTAAGCATTAAAGG
AAAAAAAAACCGGACACTAGGCGT	ATGTAAGCATTAGGCC
AAAAAAAAAGGTGCACTAAATGCA	ATGTCAATCAGGTTTA
AAAAAAAAACCATACCTAAATGCA	ATGTCAATCATGGCCA
AAAAAAAATTCATGACTAAATGCA	ATGTCAATCGGTTAGT
AAAAAAAACAGTTATCTAAATGCA	ATGTCAATCTAAGGAG
AAAAAAAAATAGATGCTAAATGCA	ATGTCAATCTACCTGC
AAAAAAAACCGGTAAACAGGCGCT	ATGTCCACAAGCCACT
AAAAAAAATAATTGGACAGGCGCT	ATGTCCACACAATGCC
AAAAAAAAGCGATTAACAGGCGCT	ATGTCCACAGAACCGA
AAAAAAAATTCACTGACAGGCGCT	ATGTCCACATCCTGAA
AAAAAAAAGATTACGACAGGCGCT	ATGTCCACATGTTGTG
AAAAAAAACGATTAAACAGGCGCT	ATGTCCACATTGTCAG
AAAAAAAACACCAGGGACGTAGTA	ATGTGAGAGTAACTCA
AAAAAAAACGTTAAGGACGTAGTA	ATGTGAGAGTCATCCC
AAAAAAAATCGTGCTGACGTAGTA	ATGTGAGAGTTGCCTC
AAAAAAAACTTTAACGACTAGTTT	ATGTTCAAGCTATATG
AAAAAAAAGTTTCCAGACTAGTTT	ATGTTCAAGCTGGCTA
AAAAAAAAGCGCTAGACGCCGGTA	ATGTTGTCAAGGTACG
AAAAAAAAATAAGCCACGCCGGTA	ATGTTGTCACCTACGG
AAAAAAAACACATAAACGCCGGTA	ATGTTGTCATGAATCT
AAAAAAAAATAATGCGATTGTGGA	ATGTTTGAGCAAGACA
AAAAAAAAGGATTGCGATTGTGGA	ATGTTTGAGGTGTTAC
AAAAAAAAGTAGTCAACAAATAGG	ATTAACCCAGCACCAT
AAAAAAAATGGGAACTGGGTGTGG	ATTACCCGTACAAAGA
AAAAAAAAAACGGTTACTTATGAG	ATTACCGCAATGCCTA
AAAAAAAACTTCGTAACTTATGAG	ATTACCGCACAACAAA
AAAAAAAAAAACCCAACTTATGAG	ATTACCGCACCTCGCT
AAAAAAAAGCAACTAACCTCAGTT	ATTACGTCAACTAGGG
AAAAAAAATCATGGAGACATCAAG	ATTACTGAGACCATAC
AAAAAAAAGATTTAGGACATCAAG	ATTACTGAGGAGCAAC
AAAAAAAAAGTTTGAGACATCAAG	ATTACTGAGTAACCAC
AAAAAAAAGATTGCGGACATCAAG	ATTACTGAGTGAACAG
AAAAAAAAGGCAATATGCAAGTAA	ATTAGCGGTAGGATTT
AAAAAAAATCAACAAACAAACTGC	ATTAGCTCAAACTGTT
AAAAAAAAGATCATGACAAACTGC	ATTAGCTCAAAGCTCC
AAAAAAAACTTAACCACAAACTGC	ATTAGCTCAATTAGGA
AAAAAAAAAGCTTGAACAAACTGC	ATTAGCTCAGCTCATA
AAAAAAAAGTCCATCACAAACTGC	ATTAGCTCATTCCTGT
AAAAAAAAAATACCTTGCAAGGAC	ATTAGGTGTTACGCAA
AAAAAAAATATGCTCACGTGCTTC	ATTAGTCCAGGGAGCT
AAAAAAAACTAGTAAACGTGCTTC	ATTAGTCCAGTAAAGC
AAAAAAAATGCGGGACTGCACACC	ATTATCCTCACACAGT
AAAAAAAATCCATAACTGCACACC	ATTATCCTCAGCACGC
AAAAAAAAGACTAGGCTGAAGGCT	ATTATGGTCCCGCCTA
AAAAAAAATGTTCCTCTGAAGGCT	ATTATGGTCTGTTGCC
AAAAAAAAGTAATCGACGCAATTG	ATTCAACCAACAGCCT
AAAAAAAAACAAGCGCTAAGCGCA	ATTCACTTCAATAGCC
AAAAAAAAGCTTTGTGATAACGAC	ATTCATGAGTCATGCG
AAAAAAAAATATAGCGATAACGAC	ATTCATGAGTTAACCA
AAAAAAAATTGGGTTTGGGATAAC	ATTCCTAGTAACAGGG
AAAAAAAAGGCTTTGTGGGATAAC	ATTCCTAGTACCGAAC
AAAAAAAATAGCGAGTGGGATAAC	ATTCCTAGTACTTAGG
AAAAAAAAGGCGGTTACCTCATTG	ATTCCTCCAAGGACCA
AAAAAAAATTGAGGACTGAGCGAT	ATTCGTTTCAAACACC
AAAAAAAAATTAAGGCTGAGCGAT	ATTCGTTTCACCGGTA
AAAAAAAATGCTGTGCTGAGCGAT	ATTCGTTTCCTGATTT
AAAAAAAATTAAGTCCTGAGCGAT	ATTCGTTTCGGTTACG
AAAAAAAAATGTTTCACGCGAACC	ATTGAAGCAGCTACGT
AAAAAAAAGATGACTACGCGAACC	ATTGAAGCATAGCAGG
AAAAAAAAAACCTAAGACAGCTAA	ATTGCACAGAATCTCA
AAAAAAAAATAGACTGACAGCTAA	ATTGCACAGCCAGGTC
AAAAAAAATATTACCGACAGCTAA	ATTGCACAGCTCAAAC
AAAAAAAAGGATATTGACAGCTAA	ATTGCACAGCTGTACG
AAAAAAAAGTCACAGGACAGCTAA	ATTGCACAGGACGTAA
AAAAAAAAAACGATTGACAGCTAA	ATTGCACAGGTTAGAG
AAAAAAAAGGGTTTCTGCAACCCG	ATTGCAGGTGGTTCTT
AAAAAAAAAGCGATTACCTAACTC	ATTGCGCCAAGCTAAA
AAAAAAAAGCTCGTTACCTAACTC	ATTGCGCCACCTATAG
AAAAAAAAGATAGACTGTCTTGGA	ATTGCTCGTATTGTGG
AAAAAAAACGCACACTGTCTTGGA	ATTGCTCGTCTTTGAC
AAAAAAAATTTAGGCTGTCTTGGA	ATTGCTCGTGGAGCAA
AAAAAAAATAAGCCTTGTCTTGGA	ATTGCTCGTTCATTTG
AAAAAAAAAGTCACAACCGGATAC	ATTGGTTCAAATATCC
AAAAAAAATGAACCGACCGGATAC	ATTGGTTCACATACTG
AAAAAAAACTAAGTAACCGGATAC	ATTGGTTCAGCATGTC
AAAAAAAATTTGTGCACCGGATAC	ATTGGTTCATAGGCGA
AAAAAAAATAAACCAACCGGATAC	ATTGGTTCATTGCAGC
AAAAAAAAGCTGAGGTGCATATCG	ATTGTCCGTGAAGCCT
AAAAAAAAGAGCTGGTGCATATCG	ATTGTCCGTGCATTTC
AAAAAAAAGGGTTTCTGCATATCG	ATTGTCCGTGGTTCTT
AAAAAAAAAGGAGGATGCATATCG	ATTGTCCGTTGTTGGA
AAAAAAAACAACTCGCTTGTTGCG	ATTGTGATCAAATCGC
AAAAAAAACGTAAAGCTTGTTGCG	ATTGTGATCAATGTCA
AAAAAAAATTCGTAACTTGTTGCG	ATTGTGATCTATGACA
AAAAAAAATCTAACCACGGATAAA	ATTTAGCCAGGCTAAG
AAAAAAAATGGTTAAACGGATAAA	ATTTAGCCATCTAGCA
AAAAAAAACGCTTTAACGGATAAA	ATTTAGCCATTGTGTG
AAAAAAAAAATAGCTGAGTTACTC	ATTTGCAAGCGATACT
AAAAAAAATGGTGCGGAGTTACTC	ATTTGCAAGCTGGACC
AAAAAAAACCTAACCGAGTTACTC	ATTTGCAAGGACCTGC
AAAAAAAACCAGCAAACTTAAAGC	ATTTGCGCACCAGGTT
AAAAAAAAGCTTATTACTTAAAGC	ATTTGCGCATAAAGCA
AAAAAAAAGGATTTAGAGCCTTTA	ATTTGTGAGGAGGTTA
AAAAAAAATTCCGGCACAATTGGC	CAAACAACATATTGAC
AAAAAAAATTCACTGACAATTGGC	CAAACAACATCCTGAA
AAAAAAAATTCAGTACTAGTCTCA	CAAACACTCCCTGGTT
AAAAAAAATTTGCGGCTAGTCTCA	CAAACACTCGCAATCG
AAAAAAAATTGAAGGCTAGTCTCA	CAAACACTCGCCTGTT
AAAAAAAAACGGTTTCTAGTCTCA	CAAACACTCGTTAACA
AAAAAAAATCCAATACTAGTCTCA	CAAACACTCTAATCAG
AAAAAAAAGGCTCATTGCTCACTC	CAAACATGTCACCAAA
AAAAAAAATCTCACCTGCTCACTC	CAAACATGTTCGCTCA
AAAAAAAAAAACATGCTATTAGCC	CAAACCGTCCAATAGC
AAAAAAAACAGGGACCTATTAGCC	CAAACCGTCCCGAACA
AAAAAAAACATTTAGCTATTAGCC	CAAACCGTCCCGTTAC
AAAAAAAACTGCTAATGGAACAAC	CAAACGCGTTACAAAC
AAAAAAAACACCATATGGAACAAC	CAAACGCGTTTATTCG
AAAAAAAAGGGTAGCTGTGCGGAA	CAAACTGGTCCTAAGA
AAAAAAAAAGCGAGCTGTGCGGAA	CAAACTGGTTTGTTGC
AAAAAAAATGCTGTTACTAGTGAT	CAAAGCGCAAGGATTA
AAAAAAAATCATCATGATTCAATC	CAAAGTGAGTCATTGA
AAAAAAAACCAATACTGTAAACAG	CAACAATGTATGGTGC
AAAAAAAAGTGATCCTGTAAACAG	CAACAATGTGGGAACA
AAAAAAAAAACGGTTACTATGTCC	CAACCCGCAATGCCTA
AAAAAAAACGGGATTACTATGTCC	CAACCCGCACATAGCC
AAAAAAAATCCTCAAACTATGTCC	CAACCCGCATCAGTAT
AAAAAAAATGGAGCGCTTTGACTA	CAACCCTTCCGTAAAC
AAAAAAAACGTTGCACTTTGACTA	CAACCCTTCGTTACAA
AAAAAAAATGTGATTCTTTGACTA	CAACCCTTCTTGGACG
AAAAAAAATGGGTAACTCATAGAG	CAACTAATCACGCATG
AAAAAAAATAGGTAGCTCATAGAG	CAACTAATCTAATCTC
AAAAAAAAGGTTCATCTCATAGAG	CAACTAATCTTAATGG
AAAAAAAACACATACTGCTTCTTA	CAACTAGGTGCAACTA
AAAAAAAAGTTATTGTGCTTCTTA	CAACTAGGTGGACCTG
AAAAAAAAGGTATAGTGCTTCTTA	CAACTAGGTGTTGTAG
AAAAAAAAGAGCGGTTGCTTCTTA	CAACTAGGTTAAGCGC
AAAAAAAATGCAAGGTGCTTCTTA	CAACTAGGTTAGCGTA
AAAAAAAAGGTAACTACACAAAGA	CAAGAACCAACAGGAT
AAAAAAAACAGCCAAACACAAAGA	CAAGAACCAAGGTCCT
AAAAAAAAAAGTCGCGATTAGTGG	CAAGACAAGCAGGTGG
AAAAAAAAGGTTTATTGCAATAAG	CAAGCTAGTAGGTTGC
AAAAAAAAAGAAACCTGCAATAAG	CAAGCTAGTCATTAGG
AAAAAAAAGGGTAGCTGCAATAAG	CAAGCTAGTCCTAAGA
AAAAAAAAACATGTTTGGAGCATA	CAAGGCTGTTCCTGTG
AAAAAAAATCCACAATGGAGCATA	CAAGGCTGTTTGCTGT
AAAAAAAAAGCATGATGCGTACTA	CAAGGGAGTATTGGTG
AAAAAAAATTTGTACGAACAAGGA	CAAGGTAAGTTGTCCC
AAAAAAAATGCGCTTGAACAAGGA	CAAGGTAAGTTTAACG
AAAAAAAAGAAATACCTAGTAGGC	CAAGGTTTCTGTGAGT
AAAAAAAATCGGTTTACCAAGTTA	CAAGTAACACAGGGAC
AAAAAAAACGGAAACTGTGACATC	CAAGTATGTTAACGAT
AAAAAAAACAGTTAGGAGAAACCC	CAAGTGAAGTAAGTGG
AAAAAAAAAAGTTAGCTCATCATA	CAAGTTATCAAACCGT
AAAAAAAAGGATTGGCTCATCATA	CAAGTTATCAGTGAAG
AAAAAAAAATACCTGCTCATCATA	CAAGTTATCATAACTG
AAAAAAAAAACGAATCTCATCATA	CAAGTTATCGCAACAT
AAAAAAAAGGTCATTCTCATCATA	CAAGTTATCGCTAGAT
AAAAAAAAAACCATGACGCAATAC	CAATAAGCAAACGCGA
AAAAAAAATCGGTTTACGCAATAC	CAATAAGCACAGGGAC
AAAAAAAAACAATAGCTATCTGTG	CAATAGCTCTAAATCG
AAAAAAAATTAGGAGCTCTAGCCA	CAATATGTCACGTTAA
AAAAAAAAAGTCGAGCTCTAGCCA	CAATATGTCATGCTAA
AAAAAAAAGATAATGCTTAGCTGC	CAATCCCTCACAGGAA
AAAAAAAATGGAGCGCTTAGCTGC	CAATCCCTCCGTAAAC
AAAAAAAATGTTGCGCTTAGCTGC	CAATCCCTCTAGCGTG
AAAAAAAAACTCAATTGGCTTGCA	CAATCCTGTGGTGAGA
AAAAAAAACTTCGCTTGGCTTGCA	CAATCCTGTTAGGATT
AAAAAAAAAGCCTGTTGGCTTGCA	CAATCCTGTTAGTACG
AAAAAAAAAACCCTTGAGTAATTG	CAATCTAAGCGATAGA
AAAAAAAAAGTTACAGAGTAATTG	CAATCTAAGCTAGAAG
AAAAAAAATAGTAACACTCACTTG	CAATGAACAGTTTGTG
AAAAAAAAGGTTATGACTCACTTG	CAATGAACATGAGCAG
AAAAAAAAGTGGTGACTATTGAGA	CAATGACTCCGCCTCA
AAAAAAAATTCGTAACTATTGAGA	CAATGACTCTATGACA
AAAAAAAACTTGTAACTATTGAGA	CAATGACTCTGCAAAC
AAAAAAAAGTTGTCCACTAGTGCG	CAATGCCCAGCGCTTG
AAAAAAAACCCTGTGACTAGTGCG	CAATGCCCATGAGTTT
AAAAAAAACTCAAGGACTAGTGCG	CAATGCCCATTAGGTT
AAAAAAAAACACCTTGAACGGTTG	CAATGTCAGTTGTCTT
AAAAAAAATAAGCCTTGAGAGCCG	CAATGTGGTTCATTTG
AAAAAAAAAGTGAATCTGTTGTTG	CACAATATCAAGCCTG
AAAAAAAAGCAATAACTGTTGTTG	CACAATATCCAGGGAG
AAAAAAAACCAGGGACTGTTGTTG	CACAATATCCCTCTAA
AAAAAAAAAGAAAGGCTGTTGTTG	CACAATATCTCACTCA
AAAAAAAATAAATCCCTGTTGTTG	CACAATATCTTGTCTG
AAAAAAAAGGAATATCTGTGGGTA	CACAGGCTCCAAACAC
AAAAAAAACGGCAAGCTGTGGGTA	CACAGGCTCCAAATCA
AAAAAAAATGCATCGCTGGTTCCG	CACATAATCGAGGAAC
AAAAAAAATATCCGCGATAGCTAG	CACATTAAGATACTTG
AAAAAAAATCACCTGGATAGCTAG	CACATTAAGCTATTGA
AAAAAAAAATATTGGGATAGCTAG	CACATTAAGCTTTGGG
AAAAAAAATCAATCCACATGAAGA	CACCAACCAGGCGATA
AAAAAAAATAGCGAGTGCACTTGA	CACCTCAGTACTTAGG
AAAAAAAAGGAGGCTTGCACTTGA	CACCTCAGTTCAAGCA
AAAAAAAAAGCCAGGTGCACTTGA	CACCTCAGTTTGCGAA
AAAAAAAAATGTTGCCTCTCACAG	CACGCAATCCGTCCAT
AAAAAAAAGTAATGACTCTCACAG	CACGCAATCGGTTTGG
AAAAAAAAGTACTTCGATTTGCTA	CACGCTAAGAGGATAT
AAAAAAAACGAGTTAGATTTGCTA	CACGCTAAGCACGATT
AAAAAAAAAGTTTGAGATTTGCTA	CACGCTAAGTAACCAC
AAAAAAAAACGTATTTGCAAGGGT	CACTAAGGTACCGTTT
AAAAAAAATACAACCTGCAAGGGT	CACTAAGGTTTGTCTA
AAAAAAAACAAACATACTAACGGC	CACTAGCCAGGTTACC
AAAAAAAATATGATGACTAACGGC	CACTAGCCATAGCTGC
AAAAAAAACTATTGCACTACGGAC	CACTGACCAATATGGA
AAAAAAAACAGGACTACTACGGAC	CACTGACCAATTGAAG
AAAAAAAACGCTAAAGATCACACC	CACTTAAAGACAACGA
AAAAAAAAAAATGCTGATCACACC	CACTTAAAGAGAGGAG
AAAAAAAATTGCAAGGATCACACC	CACTTAAAGGCCTGGT
AAAAAAAATTCGCGACTACCTCCT	CACTTTGTCTGTAATG
AAAAAAAAGGCATGACTGTAACGG	CAGAATCTCCAGGTTG
AAAAAAAATGGTCCACTGTAACGG	CAGAATCTCTTAGTGA
AAAAAAAACACACCCACAAGTAAG	CAGCAAGCACAATTAC
AAAAAAAATAGTCTCACAAGTAAG	CAGCAAGCATTAAGTC
AAAAAAAATAAACCGGACAAACAC	CAGCATTAGCAGGCCT
AAAAAAAAGATTTGAGACAAACAC	CAGCATTAGGGTCTAT
AAAAAAAAACGGCTCCTAAATGAC	CAGCCAATCAAAGGCA
AAAAAAAAGGCTTCGCTAAATGAC	CAGCCAATCCTAGTCC
AAAAAAAATAGGTGACTAAATGAC	CAGCCAATCTTGAGCG
AAAAAAAATTGAAGGCTCAAGCCT	CAGCCTTTCGCCTGTT
AAAAAAAATAAATCCCTCAAGCCT	CAGCCTTTCTTGTCTG
AAAAAAAATTAACACCTCAAGCCT	CAGCCTTTCTTTAGGA
AAAAAAAACTCCTCATGCTCAACA	CAGCTAAGTCACGAAC
AAAAAAAAGCTAAATGAGCGATAC	CAGCTATAGATAACCC
AAAAAAAAGTTAGGCGAAATACGT	CAGCTCAAGCAGGTTT
AAAAAAAATTGCAAGGAAATACGT	CAGCTCAAGGCCTGGT
AAAAAAAAGGGCATGTGGTTCACG	CAGGAAGGTTAGCAGC
AAAAAAAATCCTCCATGGTTCACG	CAGGAAGGTTGTCCAT
AAAAAAAACCGGTTCACCAACATA	CAGGACACAGTAAGTA
AAAAAAAACTTACGTACCAACATA	CAGGACACATCCGTAA
AAAAAAAATAGCAAGCTCTAGCTG	CAGGACCTCATTAGGC
AAAAAAAAGCCTGGTCTCTAGCTG	CAGGACCTCCGCAAAT
AAAAAAAAGTAGCTAACCCTGGTC	CAGGATGCAAGGTAAC
AAAAAAAACACACCCACCCTGGTC	CAGGATGCACAATTAC
AAAAAAAAATAAAGGACCCTGGTC	CAGGATGCACTAGGTC
AAAAAAAAAGTCAGTACCCTGGTC	CAGGATGCATGAAATG
AAAAAAAAAGCAATACTAACGGTG	CAGGCTATCAGCAAGA
AAAAAAAAAACTTCGCTAACGGTG	CAGGCTATCAGCATTA
AAAAAAAAGCCTGGTCTAACGGTG	CAGGCTATCCGCAAAT
AAAAAAAAAGAAAGGCTAACGGTG	CAGGCTATCTCACTCA
AAAAAAAACGCAACCTGGCTGCTA	CAGGCTGGTAGCTGGT
AAAAAAAATGCTTAGTGGCTGCTA	CAGGCTGGTCAACAAT
AAAAAAAACGATTCATGGCTGCTA	CAGGCTGGTTACCTGT
AAAAAAAATGTCAATCTTCCTTTG	CAGGGCTTCCCTCAAC
AAAAAAAATGTGATTCTTCCTTTG	CAGGGCTTCTTGGACG
AAAAAAAATAGACCAGACCATTAT	CAGGTCCAGCCTTAAA
AAAAAAAAATGCTTATGGGACATA	CAGGTTAGTGCACGCA
AAAAAAAATGGCTATTGGGACATA	CAGGTTAGTTCACTGT
AAAAAAAAGGGCTATGAGGAGGGT	CAGGTTTAGGTGAAGC
AAAAAAAATGCTTATGAGGAGGGT	CAGGTTTAGTAAACCC
AAAAAAAATATCAGGGAGGAGGGT	CAGGTTTAGTTACCGG
AAAAAAAAATTGTTCACGTCAACA	CAGTACCCAAGGTATA
AAAAAAAACGGAAACTGAACAGGT	CATAACGGTTAACGAT
AAAAAAAATCCGTAATGAACAGGT	CATAACGGTTCACCAT
AAAAAAAATGCAGGATGAACAGGT	CATAACGGTTTCCTCC
AAAAAAAAGGCGATACTTGCATGC	CATAAGCTCATCCTAT
AAAAAAAAGTTACCCACAATACCG	CATAATCCACAGAAAC
AAAAAAAAGCTCAGGACAATACCG	CATAATCCACTGGCCA
AAAAAAAATACCTCAACAATACCG	CATAATCCAGGCCAAA
AAAAAAAATAGTAACACAATACCG	CATAATCCAGTTTGTG
AAAAAAAAGATCCTACTTTAACTG	CATAATGTCAATTGGC
AAAAAAAAACAGTTAGATCATGGA	CATAGCTAGCACCACA
AAAAAAAAAGGGACGGATCATGGA	CATAGCTAGGATGATG
AAAAAAAAGATTGAGTGGTCAACC	CATAGGCGTACAATGT
AAAAAAAATGCAAGACTTAAGTTC	CATAGGTTCAACCAAC
AAAAAAAAGTCCTAACTTAAGTTC	CATAGGTTCCCATAAA
AAAAAAAATGCGTGTCTTAAGTTC	CATAGGTTCCTGGTGA
AAAAAAAATCGCCTAGAAGGACAA	CATAGTCAGTGACCTG
AAAAAAAAGCTAGTAACGGTTGGC	CATATCGCACCTAATG
AAAAAAAATCCAACTACGGTTGGC	CATATCGCAGACAAAC
AAAAAAAAGGTGATTACGGTTGGC	CATATCGCAGCACGAA
AAAAAAAACTTACTGACGGTTGGC	CATATCGCAGCACGTT
AAAAAAAAAGAAATGACGTAGCTA	CATCAATCACTTAGGC
AAAAAAAAAGACTCAACCCTCACG	CATCACACAATGCCCG
AAAAAAAAGCACCTTACCCTCACG	CATCACACAATTGACT
AAAAAAAAACCAGGTGAGTAGTTA	CATCATAAGTTGTCAA
AAAAAAAAAGCCATAACTATTAGG	CATCATGCAAGTCGCT
AAAAAAAATGTAATGACTATTAGG	CATCATGCATTAAAGG
AAAAAAAAACCGGACACTATTAGG	CATCATGCATTAGGCC
AAAAAAAACCGATTATGTTAGCTG	CATCCCAGTACCAGGT
AAAAAAAACGGTATTTGTTAGCTG	CATCCCAGTGAATCGC
AAAAAAAACAGGTCCTGTTAGCTG	CATCCCAGTGAGGTAG
AAAAAAAAGGTTAATGATCCAAGA	CATCCTCAGAACCTAC
AAAAAAAAGCGCAATGATCCAAGA	CATCCTCAGGGTGGAT
AAAAAAAAGGCGAGAGATCCAAGA	CATCCTCAGGTCGATT
AAAAAAAAAGTCACCTGCGCGGTT	CATCCTGGTTAGGTGC
AAAAAAAAGCTACAAACTCAGTCT	CATCCTTCAGGCTACT
AAAAAAAAGGTCATTCTCGCTCAA	CATCGCTTCGCTAGAT
AAAAAAAAGGAGAAACTCGCTCAA	CATCGCTTCGGTTTCC
AAAAAAAAGCACCTTACTAATGCA	CATGAGGCAATTGACT
AAAAAAAAGCTAGTAACTAATGCA	CATGAGGCACCTAATG
AAAAAAAACAGAACCACTAATGCA	CATGAGGCAGCCAGAA
AAAAAAAATGTAATGACTAATGCA	CATGAGGCATTAAAGG
AAAAAAAACGCCAACTGTGGCTAT	CATGCAAGTCATTACC
AAAAAAAAGCAATGCGAGTTGCAG	CATGCATAGAGGAAGG
AAAAAAAAGAAGTTTGAGTTGCAG	CATGCATAGCATGTTA
AAAAAAAACCTAATTGAGTTGCAG	CATGCATAGCCGCAGT
AAAAAAAAAAATGTCGAGTTGCAG	CATGCATAGCCTGTTC
AAAAAAAAACCAAATGACGGGCAT	CATGCGCAGCTATTAG
AAAAAAAACTTGACCGACGGGCAT	CATGCGCAGGCCATCA
AAAAAAAAGGGTACTGACGGGCAT	CATGCGCAGGGATTAG
AAAAAAAAAACTTCGCTGTATTGC	CATGGATTCAGCATTA
AAAAAAAACATTCCTCTGTATTGC	CATGGATTCATGAGCT
AAAAAAAAATGTTGCCTGTATTGC	CATGGATTCCGTCCAT
AAAAAAAAAGTCATCCTGTATTGC	CATGGATTCGTGCTAG
AAAAAAAATCAATTGCTGTATTGC	CATGGATTCTCCATAT
AAAAAAAATTTGCAACTACCTGAT	CATTATCTCAATGAGG
AAAAAAAATTCCTCACTACCTGAT	CATTATCTCGAAGCGG
AAAAAAAACGCAATCCTACCTGAT	CATTATCTCGAAGTGA
AAAAAAAACCCTTTACTACCTGAT	CATTATCTCGCCTAAG
AAAAAAAAACGGTTTCTACCTGAT	CATTATCTCGTTAACA
AAAAAAAAGTTAGCGGATGCAAAC	CATTATGAGCTTAGTA
AAAAAAAAGATACTCCTAAGGATT	CATTCATTCCGCAACA
AAAAAAAAGAATATGCTAAGGATT	CATTCATTCGGGCCAT
AAAAAAAAAGTCACAACAACAACC	CATTCCTCAAATATCC
AAAAAAAAAGGAAGCACAACAACC	CATTCCTCATGTTGGC
AAAAAAAACTATTTGGAGGATGCT	CATTGCGAGATGCCTG
AAAAAAAACCATTATGATAATCCT	CATTGTAAGATAGACG
AAAAAAAAGGTTGCGACGTAACGT	CATTGTGCACCCACAG
AAAAAAAATAACCGGACGTAACGT	CATTGTGCACGTAAGG
AAAAAAAAGGGAGTAACGTAACGT	CATTGTGCAGCATGAG
AAAAAAAAGGGAGGACTCCCTTTA	CATTTGTTCTCACATT
AAAAAAAAAGGCCCAACTATTGGA	CCAAACCCATGCAACC
AAAAAAAATAACTTCGAAATGCAT	CCAAACTAGCCTGGTA
AAAAAAAATATCTGTGAAATGCAT	CCAAACTAGTACTGGT
AAAAAAAAGGATATTGAGGTGCAT	CCAAATCAGCTGTACG
AAAAAAAATAAGGCTGAGGTGCAT	CCAAATCAGGTTTGCG
AAAAAAAATCGTGCTGAAACCGGT	CCAACATAGTTGCCTC
AAAAAAAAACTGAATGAAGGCCAT	CCAACCAAGCTTCCCG
AAAAAAAAAAACCATGATATAGGC	CCAAGTTAGATAAAGC
AAAAAAAAGTACAATGATATAGGC	CCAAGTTAGATTCCTT
AAAAAAAACACCAGGGATATAGGC	CCAAGTTAGTAACTCA
AAAAAAAATGAGGAAACGGGAAGT	CCAATATCAACACCTA
AAAAAAAAGGCTAGCACGGGAAGT	CCAATATCAAGGTGGC
AAAAAAAAGAAACTCACGGGAAGT	CCAATATCACCTCAGG
AAAAAAAATGGATTAACGGGAAGT	CCAATATCACCTGGTG
AAAAAAAAAAGCTATGAACTGGCA	CCACAATAGGGTCCAC
AAAAAAAAATGCTTCGACATAGAC	CCACACAAGCTCCTTA
AAAAAAAATTAAGGATGTCAAACC	CCACAGGGTTGGATCA
AAAAAAAATGGCTTATGGTCATGC	CCACATTGTGCGCAAT
AAAAAAAACGCATTATGCACAGGA	CCACTTGGTGGATTAT
AAAAAAAAGGTATAGTGCACAGGA	CCACTTGGTGTTGTAG
AAAAAAAACTCCTACTGCACAGGA	CCACTTGGTTTGACCT
AAAAAAAACAAACATACGTCAATG	CCAGACTCAGGTTACC
AAAAAAAATGTGGACACGTCAATG	CCAGACTCATTGGGAG
AAAAAAAAGATTGAGTGGCTTTAA	CCAGCCTGTACAATGT
AAAAAAAATCACGATTGGCTTTAA	CCAGCCTGTTTACGTC
AAAAAAAATAAGGTCGAGTTAGCG	CCAGCTAAGCCTGACA
AAAAAAAAGAAGTGAGAGTTAGCG	CCAGCTAAGTGATTCA
AAAAAAAAGTAATCGACAGGTTGT	CCAGCTGCAACAGCCT
AAAAAAAAAGGTTACACAGGTTGT	CCAGCTGCATCAATCG
AAAAAAAACAGGAGGACCTACCGC	CCAGGAACAAGGGTTG
AAAAAAAAGTTACCCACCTACCGC	CCAGGAACACAGAAAC
AAAAAAAATATTGGCTGTTCAAGC	CCAGGATGTCACAGAC
AAAAAAAATGGGCAATGTTCAAGC	CCAGGATGTCATCATC
AAAAAAAATAGACAATGTTCAAGC	CCAGGATGTTAAATGC
AAAAAAAAGACGTAATGTTCAAGC	CCAGGATGTTCCTGAT
AAAAAAAATGACAAATGTTCAAGC	CCAGGATGTTTAACGG
AAAAAAAACTGCCAGTGAACCGTC	CCAGTTTGTAACGGGA
AAAAAAAAAGCAAACTGAACCGTC	CCAGTTTGTAATCGGC
AAAAAAAAATACAGGTGAACCGTC	CCAGTTTGTCAATGTG
AAAAAAAACTACTAGTGAACCGTC	CCAGTTTGTCCAAGAC
AAAAAAAATTCAGTACTAGGACCA	CCATAAATCCCTGGTT
AAAAAAAAGCGCATCCTAGGACCA	CCATAAATCTAATCCT
AAAAAAAACAGATAATGCTATGAC	CCATAAGGTAGGTTAT
AAAAAAAATGGGCAATGCTATGAC	CCATAAGGTCATCATC
AAAAAAAACCTTACCTGCTATGAC	CCATAAGGTTCATCTA
AAAAAAAATCTCACCTGCTATGAC	CCATAAGGTTCGCTCA
AAAAAAAAAGACTAGTGCTATGAC	CCATAAGGTTGGCGTG
AAAAAAAAGCACCTTACTTGGACG	CCATAATCAATTGACT
AAAAAAAAGACTCAAACTTGGACG	CCATAATCAATTTGGT
AAAAAAAAACTGACAACTTGGACG	CCATAATCACAGGAAT
AAAAAAAACAGCGATACTTGGACG	CCATAATCACCTAAGC
AAAAAAAATCCCTCTACTGCAAAT	CCATAGCCAATCATGT
AAAAAAAAGATAATGCTCCCTCTG	CCATATTTCACAGGAA
AAAAAAAAATCGCGCCTCCCTCTG	CCATATTTCACCTGCT
AAAAAAAATTTCAAGCTTGCGTGT	CCATCACTCCTAATTC
AAAAAAAACTTCTATTGACTCACG	CCATCATGTGAGCACT
AAAAAAAACCCAAATTGTTAGACC	CCATTGTGTAAGGTCC
AAAAAAAAGACAATGTGTTAGACC	CCATTGTGTTAACACG
AAAAAAAACTATTGCACCTTAACC	CCCAAACCAATATGGA
AAAAAAAACGCATCCACCTTAACC	CCCAAACCAGTAGGAT
AAAAAAAAGCCTATTGAGATTCCT	CCCAAATAGCGCAATT
AAAAAAAAAAAGCTTGAGATTCCT	CCCAAATAGGTACCGC
AAAAAAAAGGATCCAGAGATTCCT	CCCAAATAGTGAACGA
AAAAAAAAGACATCCTGCATGTCA	CCCAACCGTCTAACAG
AAAAAAAAGTCACCATGCATGTCA	CCCAACCGTGACATAT
AAAAAAAAATGACTTTGCATGTCA	CCCAACCGTTATCCGT
AAAAAAAACCTTACCTGCATGTCA	CCCAACCGTTCATCTA
AAAAAAAAGGATTAGTGTCGTTAG	CCCAATTGTATTCGTC
AAAAAAAAGCCAGGATGTCGTTAG	CCCAATTGTTATCGAG
AAAAAAAAATATGCGACACTGGGC	CCCAGCACAGCAAGGC
AAAAAAAAAGGATAAACACTGGGC	CCCAGCACATGTTTGG
AAAAAAAATTGGCCACTCGATTTA	CCCAGTTTCCGGTTGA
AAAAAAAAGTTGTTGCTCGATTTA	CCCAGTTTCGTTCACC
AAAAAAAATTTCCACCTCGATTTA	CCCAGTTTCTTTGTAC
AAAAAAAATGCCTCGACAGCCTGG	CCCATAACAATAACCT
AAAAAAAACTCATTGACTTCCTCC	CCCGCAACAAATACCT
AAAAAAAATGACAATACTTCCTCC	CCCGCAACACCTCACC
AAAAAAAAAAACCATGATCCTAAT	CCCGTAAAGATAAAGC
AAAAAAAAGTTGCAGGATCCTAAT	CCCGTAAAGGCGAATA
AAAAAAAACGTTATTGATCCTAAT	CCCGTAAAGGCTTAAC
AAAAAAAAATAGCCTCTCCTTTGT	CCCGTTGTCACGCGGT
AAAAAAAATATGACAACTTGACTC	CCCTCACCAATTATGC
AAAAAAAAGGTGATTACTTGACTC	CCCTCACCAGCACGAA
AAAAAAAACAGGGACCTGCTATGT	CCCTCAGTCCCGAACA
AAAAAAAAATTGCGGGACCGTTGT	CCCTCATAGACAAACG
AAAAAAAAGTGTAATGACCGTTGT	CCCTCATAGGATTTGC
AAAAAAAAGATTCAAGACCGTTGT	CCCTCATAGGCAAGTA
AAAAAAAATAGTCTCACGCTTGGG	CCCTGGACATTAAGTC
AAAAAAAATCTAAGTCTAGTAAAC	CCCTTAATCACTCGCT
AAAAAAAAACTAAAGCTAGTAAAC	CCCTTAATCATTTGCT
AAAAAAAACCCTAAGCTAGTAAAC	CCCTTAATCTCAATTC
AAAAAAAAGGGAACCTGCTGGTTA	CCGACAGGTGGATTCA
AAAAAAAACCGCTAGTGCTGGTTA	CCGACAGGTTAGTGAT
AAAAAAAACATGTCATGCTGGTTA	CCGACAGGTTGTTGCT
AAAAAAAATTTGCGCGAAACCGAC	CCGATGCAGTCTCACC
AAAAAAAAACTAAGACTCCTCACC	CCGCAAATCTTAGCCC
AAAAAAAAGGCATGGTGATTAGGG	CCGCAAGGTCATAGAT
AAAAAAAACGCTTTAACCTGAATA	CCGCCAACATTGTGTG
AAAAAAAAAGTCAATGAACCGAAC	CCGCTAAAGCGCTAAT
AAAAAAAACACAGGCGAACCGAAC	CCGCTAAAGGACTTAC
AAAAAAAAGAACCTAACTCCTCTC	CCGCTAGCAGCTTACA
AAAAAAAAGCCTCTCTGATTGATC	CCGCTTAGTCCTCCAA
AAAAAAAACCGCTAGTGATTGATC	CCGCTTAGTTAGTGAT
AAAAAAAATTAAGGATGATTGATC	CCGCTTAGTTGGATCA
AAAAAAAATCGGTATTGATTGATC	CCGCTTAGTTTAGTCC
AAAAAAAACACCATATGATTGATC	CCGCTTAGTTTATTCG
AAAAAAAATCCTTAAGAAGATTCA	CCGGTTAAGCACAGAA
AAAAAAAAAGAGGATGAAGATTCA	CCGGTTAAGCATGGTT
AAAAAAAATCACGATTGACCGCTA	CCGTGCTGTTTACGTC
AAAAAAAAGGTTGTAACTTAGGTA	CCGTTAACAATCGCAC
AAAAAAAATAGTAACACTTAGGTA	CCGTTAACAGTTTGTG
AAAAAAAACTTGAATCTAATTGCC	CCGTTACTCCCGCAAA
AAAAAAAATGACTTACTAATTGCC	CCGTTACTCGAGGTGG
AAAAAAAACCGGTACTGAGATTCT	CCGTTATGTAAGTCGC
AAAAAAAACGCTACGTGAGATTCT	CCGTTATGTGTGCAAC
AAAAAAAAGGAGCAAACCGTTCCG	CCTAAGCCACAGGATG
AAAAAAAAACACTTGCTTCATTAG	CCTAAGGTCAACAAGG
AAAAAAAAGAGGGAGCTTCATTAG	CCTAAGGTCATGCTCC
AAAAAAAAGCGGTAACTTCATTAG	CCTAAGGTCATGGTTA
AAAAAAAATGTTGTTGATTGCGGG	CCTAAGTAGACAACAG
AAAAAAAACCTTAATGATTGCGGG	CCTAAGTAGTCATTAG
AAAAAAAACGAGTTAGACAGAATC	CCTAATAAGCACGATT
AAAAAAAACATAGTGGACAGAATC	CCTAATAAGGGTGAAC
AAAAAAAATTTATCCTGACATGCC	CCTAATCGTCGCAAAC
AAAAAAAAATGTTGTTGAGCCGGA	CCTACTGGTTACATCC
AAAAAAAAGTCACACTGCCCGTAG	CCTAGTTGTCGACTCC
AAAAAAAATCTTCATTGCCCGTAG	CCTAGTTGTGGACATC
AAAAAAAAATTGTCTACGCCTTTG	CCTATAGCAATCCTGA
AAAAAAAAGCTACAAACGCCTTTG	CCTATAGCAGGCTACT
AAAAAAAACCATTACACGCCTTTG	CCTATAGCATTGTGAT
AAAAAAAACCTTGAGCTAGTTACC	CCTATATTCATAATCG
AAAAAAAAATTACGCCTAGTTACC	CCTATATTCCACAATA
AAAAAAAATTTATGGCTAGTTACC	CCTATATTCGGTACGC
AAAAAAAAGCCTAATCTAGTTACC	CCTATATTCGTTAGTA
AAAAAAAAGTTGTTGCTGTAATGA	CCTATTGTCGTTCACC
AAAAAAAATTCGTAACTGTAATGA	CCTATTGTCTATGACA
AAAAAAAACTTAATGCTGTAATGA	CCTATTGTCTTAGGGT
AAAAAAAATCTTAGTGAAACATTG	CCTATTTAGCAATAGG
AAAAAAAAAGTGTGCGAAACATTG	CCTATTTAGCTTACTT
AAAAAAAATCGACCTGAAACATTG	CCTATTTAGGATCCGC
AAAAAAAAAGACTCAACCTAAGCG	CCTCAAACAATGCCCG
AAAAAAAAACCCTCAACCTAAGCG	CCTCAAACAGCATTAT
AAAAAAAAGGTTTATTGGCTGTTG	CCTCAATGTAGGTTGC
AAAAAAAAGCAGTAATGGCTGTTG	CCTCAATGTATTGGAT
AAAAAAAACCTAGCGTGGCTGTTG	CCTCAATGTTAGGACC
AAAAAAAACGACTTGCTATGGCCC	CCTCAGTTCAAGTGTC
AAAAAAAACGGCAAGCTATGGCCC	CCTCAGTTCCAAATCA
AAAAAAAAGTGGTGACTATGGCCC	CCTCAGTTCCGCCTCA
AAAAAAAAATGTTGCCTATGGCCC	CCTCAGTTCCGTCCAT
AAAAAAAAAGCAATACTTCGCGAT	CCTCCTCTCAGCAAGA
AAAAAAAACAGGGACCTTCGCGAT	CCTCCTCTCCCGAACA
AAAAAAAAGGTTATCCTTCGCGAT	CCTCCTCTCGTTATAG
AAAAAAAATCAGCAAGATTAAGCG	CCTCCTGAGCAGCTCA
AAAAAAAAATGTGCGGATTAAGCG	CCTCCTGAGCCTGTGA
AAAAAAAACTAGGCGGATTAAGCG	CCTCCTGAGGGACTAA
AAAAAAAAAATGAGGGATTAAGCG	CCTCCTGAGTAGCCAT
AAAAAAAACATTTGTGATTAAGCG	CCTCCTGAGTCACCAG
AAAAAAAAGGTCCAAGATTCACCG	CCTGAATAGCGCCTAA
AAAAAAAATGCTTATGATTCACCG	CCTGAATAGTAAACCC
AAAAAAAATTACCTCCTGTGCTGC	CCTGACTTCATTGTTC
AAAAAAAAAAGTAACCTGTGCTGC	CCTGACTTCTTGATGA
AAAAAAAACATCGTTACTCATGCT	CCTGAGTCAACATAAG
AAAAAAAACAACAGCACTCATGCT	CCTGAGTCAATAACGA
AAAAAAAAGTCAAGCGAAACTGGC	CCTGATGAGACTTATG
AAAAAAAAGTACTTCGAAACTGGC	CCTGATGAGAGGATAT
AAAAAAAAGTTACCTGAAACTGGC	CCTGATGAGGATTGCT
AAAAAAAAAATGAGGGAAACTGGC	CCTGATGAGTAGCCAT
AAAAAAAACATCCGTGAAACTGGC	CCTGATGAGTTTCCTG
AAAAAAAACTGGGTAACGGGTTTA	CCTGCTCCAAACTAAG
AAAAAAAATTGCATCACGGGTTTA	CCTGCTCCAAGTGTTT
AAAAAAAAGCTTATTACGGGTTTA	CCTGCTCCATAAAGCA
AAAAAAAAGCGGTGTACAACTAGC	CCTGGATCACCTGCTC
AAAAAAAATTAAGGTACAACTAGC	CCTGGATCAGTAGGTG
AAAAAAAATCCTCCTACAACTAGC	CCTGGATCATAATCAC
AAAAAAAAGCTGGTGACAACTAGC	CCTGGATCATGCTATG
AAAAAAAACTCAAGGACAACTAGC	CCTGGATCATTAGGTT
AAAAAAAACGTAGTAGATGAATGC	CCTGGTAAGGATAAAC
AAAAAAAATGTCCTGGATGAATGC	CCTGGTAAGGTGAGAC
AAAAAAAAATGGTTAGATGAATGC	CCTGGTAAGGTTAGCT
AAAAAAAACACCAAAGATGAATGC	CCTGGTAAGTCAATTG
AAAAAAAACGATCCTGATGAATGC	CCTGGTAAGTGAGGTA
AAAAAAAATTCACTGACTCCTAAC	CCTGTAACATCCTGAA
AAAAAAAAATCCCAGTGCGACACC	CCTGTATGTGCTTACT
AAAAAAAATCGGTATTGCGACACC	CCTGTATGTTTAGTCC
AAAAAAAATACAACCTGCGACACC	CCTGTATGTTTGTCTA
AAAAAAAAAATACCTTGCTCAAAC	CCTGTTGGTTACGCAA
AAAAAAAACAGCCAAACAGATAGA	CCTTACTCAAGGTCCT
AAAAAAAAGCACCTTACAGATAGA	CCTTACTCAATTGACT
AAAAAAAATTGTTGGTGGTCCACA	CCTTAGTGTAGGTTTG
AAAAAAAACAGGCCTTGGTCCACA	CCTTAGTGTCATGAGC
AAAAAAAAGTCGAGGTGGTCCACA	CCTTAGTGTTAATGCG
AAAAAAAATTAGTGCTGGTCCACA	CCTTAGTGTTGTCATC
AAAAAAAAAAGTAACCTTGATTTG	CCTTATGTCTTGATGA
AAAAAAAATTATAGCCTCCTTAGG	CCTTCAATCGTTATCT
AAAAAAAATCTCAAACTCCTTAGG	CCTTCAATCTGCAAGT
AAAAAAAATAAATCCCTCCTTAGG	CCTTCAATCTTGTCTG
AAAAAAAAGCGCATCCTGCATCTA	CCTTCGGTCTAATCCT
AAAAAAAATAGACCAGATCTTTGA	CCTTCGTAGCCTTAAA
AAAAAAAACGTTAAGGATCTTTGA	CCTTCGTAGTCATCCC
AAAAAAAAGACAAGCCTTTCAGTA	CCTTGCGTCTCAATGA
AAAAAAAAGTCATAGACGGTTTAG	CCTTGTTCAAGCGATG
AAAAAAAAAAGCCTAACGGTTTAG	CCTTGTTCATATAACC
AAAAAAAACTACTTCCTCAGTATT	CCTTTAGTCATTGCGG
AAAAAAAATCTATGTGATTGTTTG	CGAAATGAGGGTGAGT
AAAAAAAAGACCTGCCTTTAACGT	CGAAGAATCTAGCGAT
AAAAAAAACGCGAGTGAAACAATC	CGAAGTAAGAAAGGAA
AAAAAAAAGGCTTAGGAAACAATC	CGAAGTAAGACACTTA
AAAAAAAAGATGAAGGATTAGGTG	CGAATCTAGCCTGAGC
AAAAAAAAAATTACGGATTAGGTG	CGAATCTAGTAACCCG
AAAAAAAAACATTAGGATTAGGTG	CGAATCTAGTTCCCGT
AAAAAAAAGCAATTGACTAACTGA	CGACAAGCATTGACAT
AAAAAAAACGCATCCACGATAGAA	CGACCTGCAGTAGGAT
AAAAAAAAGGGTAGCTGAGCATAG	CGACTAAGTCCTAAGA
AAAAAAAATACCGGCTGAGCATAG	CGACTAAGTCGCGCAA
AAAAAAAAGACATCCTGAGCATAG	CGACTAAGTCTAACAG
AAAAAAAAAGTCACCTGAGCATAG	CGACTAAGTTAGGTGC
AAAAAAAATAGCCCTGACGCCTAT	CGAGCGAAGTGAACCT
AAAAAAAAGTGCGAGTGCTCTCAC	CGAGCTGGTATTGAGT
AAAAAAAACTTCGCTTGCTCTCAC	CGAGCTGGTTAGGATT
AAAAAAAAGCGCATTTGAAGGCTA	CGAGGAAGTTGTTGTC
AAAAAAAACGTGCTGTGAAGGCTA	CGAGGAAGTTTAGCGA
AAAAAAAATATTCCTTGAAGGCTA	CGAGGAAGTTTGCAGA
AAAAAAAAGTAGTCCTGACAAAGC	CGAGTCGGTGCAATGC
AAAAAAAACATGCTATGACAAAGC	CGAGTCGGTGTAACCA
AAAAAAAACAGCCAAACTAAGTAC	CGATATTCAAGGTCCT
AAAAAAAATATAGTGACTAAGTAC	CGATATTCAGCTCAAC
AAAAAAAATACCCTTCTTATTGAC	CGATCCTTCCTCCTAA
AAAAAAAACGACAAACTTATTGAC	CGATCCTTCTTTAAGG
AAAAAAAATTAACACCTTATTGAC	CGATCCTTCTTTAGGA
AAAAAAAAGCAACTAACACGGACC	CGATGTCCAACTAGGG
AAAAAAAAGCCTGTTACGTCCAGG	CGATTATCAAACCCTA
AAAAAAAAATCTGGAACGTCCAGG	CGATTATCAGGTTTGC
AAAAAAAATAGCAAGCTAACGAGC	CGATTCCTCATTAGGC
AAAAAAAACTAGACCCTAACGAGC	CGATTCCTCTTAGCGG
AAAAAAAATGGGCAATGTATTGGC	CGATTGAGTCATCATC
AAAAAAAATTGAGCTTGTATTGGC	CGATTGAGTGAGGTGA
AAAAAAAAGACGTAATGTATTGGC	CGATTGAGTTCCTGAT
AAAAAAAAAGCCCTTACTAATTGG	CGATTTGCATTCAGCA
AAAAAAAAACCATACCTGCCAGAA	CGCAAATTCATGGCCA
AAAAAAAAAACTAAGCTGCCAGAA	CGCAAATTCGGGATTT
AAAAAAAATAGGTAGCTGCCAGAA	CGCAAATTCTAATCTC
AAAAAAAAGTTGCTGTGCGGTACC	CGCAATAGTATACTGG
AAAAAAAATGCGTGAACTAAGGAG	CGCAATCCACATTAAC
AAAAAAAAGTGTTTGCTTCAATCA	CGCAATGTCACCAATA
AAAAAAAACACTATACTTCAATCA	CGCAATGTCTGGCATG
AAAAAAAAGATCCAGGAGAGCAAA	CGCAATTAGCCGCTTT
AAAAAAAATCACATTGAGAGCAAA	CGCAATTAGGCGCACT
AAAAAAAAGGTAGCTGAGAGCAAA	CGCAATTAGTCTTGAA
AAAAAAAATGCGCTTGAGAGCAAA	CGCAATTAGTTTAACG
AAAAAAAATCCATAACTAGTGACG	CGCACAATCAGCACGC
AAAAAAAAGAGGGAGCTAGTGACG	CGCACAATCATGCTCC
AAAAAAAAGCGACTCCTAGTGACG	CGCACAATCGCTATGG
AAAAAAAAATATCAGGAAATGACT	CGCACACAGTGAAGTG
AAAAAAAAGTTAGTAGATACTTGT	CGCATATAGAGGAGTC
AAAAAAAAAAGAAGCGATACTTGT	CGCATATAGCGATAAG
AAAAAAAAGGATATTGATACTTGT	CGCATATAGCTGTACG
AAAAAAAACGCTTGTGATACTTGT	CGCATATAGTAACGGA
AAAAAAAATCAAACAACAAAGAAC	CGCATTACAGGATGGC
AAAAAAAATAGTAACACAAAGAAC	CGCATTACAGTTTGTG
AAAAAAAATCCTCAAACAAAGAAC	CGCATTACATCAGTAT
AAAAAAAACCGAAGTACAAAGAAC	CGCATTACATGGCCCA
AAAAAAAATCCTGAATGCTGTGAT	CGCATTTGTTATAGCG
AAAAAAAAGCATGAGCTTATGGGA	CGCCAAATCCACCCTG
AAAAAAAATTTCAAGCTTATGGGA	CGCCAAATCCTAATTC
AAAAAAAAGCGCATCCTTATGGGA	CGCCAAATCTAATCCT
AAAAAAAACTACTAACTTATGGGA	CGCCAAATCTGTTCAT
AAAAAAAATCTTGCTCTTTGACCG	CGCCTCATCAGTTCCC
AAAAAAAACGCTTAGCTTTGACCG	CGCCTCATCCTTCTAG
AAAAAAAAGTCACCATGATGTTGT	CGCCTGTGTGACATAT
AAAAAAAACAAACCGACAACAGCT	CGCGATTCACACAATT
AAAAAAAATAGAATCACAACAGCT	CGCGATTCAGTAATAG
AAAAAAAACCATTGTACAACAGCT	CGCGATTCATAAGGAC
AAAAAAAATACAACAACCAAAGGA	CGCTAACCAACTAGCC
AAAAAAAAATGAATCGAGCCACAA	CGCTAATAGAACAAGT
AAAAAAAACCTTGTTCTTAGAGGT	CGCTACTTCATCCTCA
AAAAAAAATCACCATACTGATCAA	CGCTCAGCAAGACTCC
AAAAAAAAAGCTTGAACTGATCAA	CGCTCAGCAGCTCATA
AAAAAAAACGTGAAACTTCGCTCC	CGCTCCATCAAGGACA
AAAAAAAAGCGGTAACTTCGCTCC	CGCTCCATCATGGTTA
AAAAAAAACGTTTGGCTTCGCTCC	CGCTCCATCCTTAAGA
AAAAAAAATCCCTCTACCTTGTTG	CGCTGTGCAATCATGT
AAAAAAAAAGTTGTCCTAGATTCC	CGCTTACTCAATTACG
AAAAAAAAATAGCTCCTAGATTCC	CGCTTACTCCTTAATC
AAAAAAAAAAATCCTTGAAGGCCG	CGCTTGCGTGTTTCAC
AAAAAAAAGTCTTTAACTTCCTGA	CGGACAACACAATGTT
AAAAAAAAGGCTTAGGAGGCCTAA	CGGACCTAGACACTTA
AAAAAAAATCCCTTTGAGGCCTAA	CGGACCTAGGCATTAC
AAAAAAAACACCAAAGAGGCCTAA	CGGACCTAGTCAATTG
AAAAAAAACAGGTTCCTTGTGTGC	CGGAGTCTCACTTTAC
AAAAAAAACCTGCAACTTGTGTGC	CGGAGTCTCATTGACA
AAAAAAAACGGAGCACTTGTGTGC	CGGAGTCTCCTAGTAA
AAAAAAAATAGTCGAGAGTAATGT	CGGATAAAGCTGTAAC
AAAAAAAACTCAAAGGAGTAATGT	CGGATAAAGGAAGCTA
AAAAAAAATATCTGTGAGTAATGT	CGGATAAAGTACTGGT
AAAAAAAAGCCTCTCTGTTGTCCC	CGGATTAGTCCTCCAA
AAAAAAAAGTCACCATGTTGTCCC	CGGATTAGTGACATAT
AAAAAAAAGAGCTGGTGAATATCC	CGGCAATGTGCATTTC
AAAAAAAACATCCGTGACGGTTTC	CGGCCATAGTTTCCTG
AAAAAAAACTCCCACCTGTGACCC	CGGCTAATCCCTGACT
AAAAAAAACGCTTAGCTGTGACCC	CGGCTAATCCTTCTAG
AAAAAAAATTGCCAGCTGTGACCC	CGGCTAATCGCTAAGT
AAAAAAAAGGAAGCAACACCTTGC	CGGCTCACACTAAGTT
AAAAAAAATAGAGATTGATTATGC	CGGGTATGTTTGGCTT
AAAAAAAATCGTTATGAGACTAAT	CGGTTATAGTTTGGGT
AAAAAAAATAACCTTGAAATCATG	CGGTTTGAGGAACCAA
AAAAAAAATGCTGTTACACAAGCT	CGTAACCCAAGGATTA
AAAAAAAACAAACCGACACAAGCT	CGTAACCCACACAATT
AAAAAAAATGTGGACACACAAGCT	CGTAACCCATTGGGAG
AAAAAAAAGGAACAAGATGTTGCC	CGTAACTAGCACTTGG
AAAAAAAATTGGTTTGATGTTGCC	CGTAACTAGCCTAATA
AAAAAAAATGAGCGCGATGTTGCC	CGTAACTAGCTAATCA
AAAAAAAAACTGAATGATGTTGCC	CGTAACTAGCTTCCCG
AAAAAAAACGATCCTGATGTTGCC	CGTAACTAGTGAGGTA
AAAAAAAATTTGTGTGAGGCCTTC	CGTAGTTAGCAAGATG
AAAAAAAAGTGGGAGGAGGCCTTC	CGTAGTTAGCGGATAA
AAAAAAAAAGAGGCGGAGGCCTTC	CGTAGTTAGGCCTAAT
AAAAAAAAGAGAAGCACAAGCCAT	CGTATTGCATGTGGGA
AAAAAAAAGAATCACACAAGCCAT	CGTATTGCATTGCGTA
AAAAAAAATATCCATGATGGACCG	CGTCAATAGAGCCGGA
AAAAAAAACTGGCAGGATGGACCG	CGTCAATAGCCTCTCG
AAAAAAAACCGATTATGTAATGCC	CGTCATTGTACCAGGT
AAAAAAAAGGGCGATTGTAATGCC	CGTCATTGTAGACAAA
AAAAAAAATGGAGCATGTAATGCC	CGTCATTGTCATTGAG
AAAAAAAATGCTTGATGCTCCGGA	CGTCCTAGTTGGTGAC
AAAAAAAAACACTTGCTTAACGTT	CGTGACATCAACAAGG
AAAAAAAAGGTTAATGAACGCGTA	CGTGCACAGAACCTAC
AAAAAAAAATTGTTCACGCATGAT	CGTGCTGCAAGGTATA
AAAAAAAACAATTTGCTGCTGTGC	CGTGCTTTCTAACCTT
AAAAAAAATGATTAGACTATTGAG	CGTGGTTCAGCAAGTG
AAAAAAAAGTCCATCACTATTGAG	CGTGGTTCATTCCTGT
AAAAAAAAGAATATGCTCACCAAC	CGTTAAATCGGGCCAT
AAAAAAAAATTTCGCGAGTGATTA	CGTTAACAGCAAGGAC
AAAAAAAATCTTGCTCTAATCCTG	CGTTAGGTCAGTTCCC
AAAAAAAAATAGATGCTAATCCTG	CGTTAGGTCTACCTGC
AAAAAAAATTCGCGACTAATCCTG	CGTTAGGTCTGTAATG
AAAAAAAAGGCTTCATGAGGCAAT	CGTTATCGTGTTGTGA
AAAAAAAAGGCTTTACTGGACCTC	CGTTATTTCCTCAGCT
AAAAAAAAAAATTGCGAGCAAGGG	CGTTGCAAGTTATCTC
AAAAAAAAACTTGTCGAGCAAGGG	CGTTGCAAGTTATGTG
AAAAAAAAGGCGGTTACATTACCT	CGTTTCTCAAGGACCA
AAAAAAAAGCTCGTTACATTACCT	CGTTTCTCACCTATAG
AAAAAAAACTAGTCTACATTACCT	CGTTTCTCAGTTTACG
AAAAAAAACTATATGCTCCTAATA	CTAAAGCTCCCTGATC
AAAAAAAAACGTTGTCTCCTAATA	CTAAAGCTCGATTTAG
AAAAAAAACTATTAGCTAGGTTGG	CTAAATGTCCAAGTTA
AAAAAAAAGCCTGGTCTAGGTTGG	CTAAATGTCCGCAAAT
AAAAAAAAGATGAATCTAGGTTGG	CTAAATGTCCTTGCGT
AAAAAAAAACTCACACTAGGTTGG	CTAAATGTCGGTCATG
AAAAAAAAGGCCGATACAAAGCTC	CTAACCACAATTAACC
AAAAAAAATGCTACTACAAAGCTC	CTAACCACATGCTCCC
AAAAAAAAGGTTAACACAAAGCTC	CTAACCACATTATGCG
AAAAAAAAGTCAATGACAAAGCTC	CTAACCACATTGCGGT
AAAAAAAAAACTTCGCTATGGAGC	CTAACCCTCAGCATTA
AAAAAAAATAGCTATCTATGGAGC	CTAACCCTCCGGCTAA
AAAAAAAAGGCTCATTGCTCCAAA	CTAACCTGTCACCAAA
AAAAAAAATAACCGTTGCTCCAAA	CTAACCTGTTACGCGG
AAAAAAAATGCATTACTAGAGATT	CTAAGGTTCAGCAAAG
AAAAAAAATCAGCACCTAGAGATT	CTAAGGTTCGAAGTAG
AAAAAAAAGAAGCCACTAGAGATT	CTAAGGTTCGGCTATG
AAAAAAAAACAGCCAGACTAGTGA	CTAAGTCAGCTAAGTC
AAAAAAAACCGAAGCGACTAGTGA	CTAAGTCAGTTTGGTA
AAAAAAAAGATAATGCTACTAGTC	CTAATAGTCACAGGAA
AAAAAAAAGTCGATTCTACTAGTC	CTAATAGTCATTTGTC
AAAAAAAATTACCGGCTACTAGTC	CTAATAGTCCCTCGCA
AAAAAAAAGTGATGGCTACTAGTC	CTAATAGTCTTGCTAT
AAAAAAAATGGAGCATGATGACTT	CTAATCCGTCATTGAG
AAAAAAAATTACTGCACTGGCTTT	CTAATCGCAGTATGTT
AAAAAAAACTAGCCACTGCAATCT	CTAATCTTCCTGAATA
AAAAAAAAAACGGGAACAGAACCT	CTAATGTCAACTAACT
AAAAAAAAGTTCAAGACAGAACCT	CTAATGTCACCGGTAT
AAAAAAAAGCTATTTACAGAACCT	CTAATGTCAGTTAAAG
AAAAAAAACCGGATAACAGAACCT	CTAATGTCATGAATAG
AAAAAAAAGTGAACCGAACAGTTA	CTAATTGAGCAAACCT
AAAAAAAAGGAGCTTGAACAGTTA	CTAATTGAGTCATTTC
AAAAAAAATGTTGTTGAGTGAGGG	CTACAACAGACAACAG
AAAAAAAAAAATGCTGAGTGAGGG	CTACAACAGAGAGGAG
AAAAAAAATGTTGTTGAGCTAAAT	CTACCTCAGACAACAG
AAAAAAAAGAGGTGGGAGCTAAAT	CTACCTCAGAGGGACT
AAAAAAAAGCGGTTAGAGCTAAAT	CTACCTCAGTAGCGGG
AAAAAAAATTGGGTTTGGCGAAAT	CTACGAAGTAACAGGG
AAAAAAAACCTTTGGGAGTCAATA	CTACTAAAGAGAAGGG
AAAAAAAAGGTATAGTGCCTAATG	CTACTTAGTGTTGTAG
AAAAAAAAAAGCTAGTGCCTAATG	CTACTTAGTTGCGCGA
AAAAAAAAGTGCTGGACAACATGC	CTAGATTCACCCACCT
AAAAAAAATCGGTATTGCATTAGC	CTAGCGGGTTTAGTCC
AAAAAAAATTTAGCTGATTGCTGC	CTAGCTGAGTAATCCA
AAAAAAAACTCAGGCTGCGTGACC	CTAGCTTGTAATCCCT
AAAAAAAAGAGCTGGTGCGTGACC	CTAGCTTGTGCATTTC
AAAAAAAACAGTCTATGTCCGTAA	CTAGGACGTGTTTGAG
AAAAAAAAAGCACCTTGATTGCAT	CTAGGCGGTGCTTAGA
AAAAAAAACAGGTTCCTTAACGGA	CTAGTAATCACTTTAC
AAAAAAAATCAATTGCTTAACGGA	CTAGTAATCTCCATAT
AAAAAAAACTAGACCCTTAACGGA	CTAGTAATCTTAGCGG
AAAAAAAAGATAGACTGTTTCGGA	CTAGTAGGTATTGTGG
AAAAAAAACAGCATTTGTTTCGGA	CTAGTAGGTGAACAAA
AAAAAAAATGGTCATTGTTTCGGA	CTAGTAGGTGCTAGCG
AAAAAAAATTATTCCTGTTCGTTT	CTAGTGAGTGCTTTAC
AAAAAAAATCAGGACACTGGCCAA	CTAGTTGCAATAGTCT
AAAAAAAAGCGGTACACTGGCCAA	CTAGTTGCATAGTCAT
AAAAAAAAGATGACTACTTCGGGA	CTATAACCATAGCAGG
AAAAAAAATTGCAAGGACTTGCTG	CTATGACAGGCCTGGT
AAAAAAAATTGACTCACGCTAGGC	CTATGATCAAAGGCCA
AAAAAAAACATAAGTACGCTAGGC	CTATGATCAAATTCGT
AAAAAAAACGCATCCACGCTAGGC	CTATGATCAGTAGGAT
AAAAAAAAGGTTACAACCAGGTTG	CTATGGCCAATACTGT
AAAAAAAACGCATCCACCAGGTTG	CTATGGCCAGTAGGAT
AAAAAAAAACCTGCTACCAGGTTG	CTATGGCCATTGCGAC
AAAAAAAACAACTCGCTAAAGGTT	CTATGTTTCAAATCGC
AAAAAAAAAGAGAAGCTAAAGGTT	CTATGTTTCGTCAAGT
AAAAAAAATTATAGCCTAAAGGTT	CTATGTTTCGTTATCT
AAAAAAAAGCAAATACTAAAGGTT	CTATGTTTCTCGACCT
AAAAAAAACCTGCTCCTAAAGGTT	CTATGTTTCTTGACCC
AAAAAAAAACTGCGCCTTGACCGT	CTATTACTCGTAACGT
AAAAAAAAACTGAATGAGCTTAGG	CTATTGAAGCTTCCCG
AAAAAAAAAGGGACGGAGCTTAGG	CTATTGAAGGATGATG
AAAAAAAACTATCGCGAGCTTAGG	CTATTGAAGTCACTCC
AAAAAAAACCTTAATGAGCTTAGG	CTATTGAAGTCATTAG
AAAAAAAACATGATGGATTACTAC	CTCAATAAGGCCTTAG
AAAAAAAAGTTGCAGGATTACTAC	CTCAATAAGGCGAATA
AAAAAAAACACTAAGGATTACTAC	CTCAATAAGTTCCTCA
AAAAAAAAAACGGGAACTATCCGT	CTCACAACAACTAACT
AAAAAAAACAAACATACTATCCGT	CTCACAACAGGTTACC
AAAAAAAATATGTCCACTATCCGT	CTCACAACATAAGTTC
AAAAAAAAATGACAACTGGCCAAA	CTCACACTCATGCCTC
AAAAAAAACTTGTTCCTGGCCAAA	CTCACACTCGATTATG
AAAAAAAATTCTAAGCTGGCCAAA	CTCACACTCGTACCGA
AAAAAAAACCTCCTCGACCAAATG	CTCACTCAGGACAATG
AAAAAAAACTTGAAGGACCAAATG	CTCACTCAGTAAGAAC
AAAAAAAAGGTTTGTCTTCTCACT	CTCAGGATCACGCCAA
AAAAAAAATTTGCGGCTAAGCACG	CTCATCATCGCAATCG
AAAAAAAATCTTGCAACGCTAAAC	CTCATGACAGGCTTGT
AAAAAAAAACTGCAAACGCTAAAC	CTCATGACAGTTATGT
AAAAAAAACTGAGTGACGCTAAAC	CTCATGACATCCATCT
AAAAAAAAGGCCTCACTAATGCCT	CTCATGCTCATGCTTT
AAAAAAAATACCCTTCTAATGCCT	CTCATGCTCCTCCTAA
AAAAAAAACAGGAATCTAATGCCT	CTCATGCTCTCTAGCC
AAAAAAAAACCCAACTGCGCCATG	CTCATTAGTAATTAGC
AAAAAAAACAGGTCCTGCGCCATG	CTCATTAGTGAGGTAG
AAAAAAAAGTCCTAACTGGTTCAT	CTCATTGTCCCATAAA
AAAAAAAAAATCCACCTGGTTCAT	CTCATTGTCCCGAAGC
AAAAAAAATTCAGTACTGGTTCAT	CTCATTGTCCCTGGTT
AAAAAAAAGATTCACCTGGTTCAT	CTCATTGTCCTCATGC
AAAAAAAATGGTCCACTGGTTCAT	CTCATTGTCTTAGTGA
AAAAAAAAAGCGTGCACCGGGTAT	CTCCAAACAGAAACGT
AAAAAAAACAACGGTACCGGGTAT	CTCCAAACAGCAGGTA
AAAAAAAACCCTGTGACCGGGTAT	CTCCAAACATGAGTTT
AAAAAAAACCAGGGACTAGTAAGT	CTCCAACTCCCTCTAA
AAAAAAAATTGTTGACTAGTAAGT	CTCCAACTCTGGTCCT
AAAAAAAATGAATTGACCACATAA	CTCCGGACAATAATGG
AAAAAAAATCCTCCTACCACATAA	CTCCGGACATAATCAC
AAAAAAAACATAAGTACCCTGTGC	CTCCGTCCAAATTCGT
AAAAAAAATTTACGCACCCTGTGC	CTCCGTCCAAGGTGCA
AAAAAAAACAGAGGGACCCTGTGC	CTCCGTCCAGTTAGCC
AAAAAAAAATGGTCAACTGTTCAC	CTCCTCACAGTCTATG
AAAAAAAAACTAAGGTGAGGAGAG	CTCCTGAGTATTACCC
AAAAAAAAGCTCCCTTGAGGAGAG	CTCCTGAGTCTCACTG
AAAAAAAACATGCTATGAGGAGAG	CTCCTGAGTGTAACCA
AAAAAAAAGCGCATTTGAGGAGAG	CTCCTGAGTTGTTGTC
AAAAAAAAACATAACGATGGCCGA	CTCGACAAGAACCTGT
AAAAAAAAACAACATGATGGCCGA	CTCGACAAGAGAGGCT
AAAAAAAATCAGTTTGATGGCCGA	CTCGACAAGTTAGGCT
AAAAAAAAATCTGGAACCGCACTC	CTCGCTCCAGGTTTGC
AAAAAAAACATGGTGACCGCACTC	CTCGCTCCATACCCGG
AAAAAAAACCTTCATCTGCATCGC	CTCGTTATCGTTAGCG
AAAAAAAAGTAGCTAACCGCAACA	CTCTAAGCAAGGTAAC
AAAAAAAAGCGACTCCTCTACTAA	CTCTAGCTCGCTATGG
AAAAAAAAGGTTCATCTCTACTAA	CTCTAGCTCTTAATGG
AAAAAAAAGTGCAAGCTTCAAGGA	CTCTATGTCCGCCTAT
AAAAAAAATTCGCGACTTCAAGGA	CTCTATGTCTGTAATG
AAAAAAAAAAACCATGAACCTTGT	CTCTCACAGATAAAGC
AAAAAAAAATGGTTAGAACCTTGT	CTCTCACAGGTTAGCT
AAAAAAAATGAAGCCACATCATGG	CTCTGTTCAAGCTACC
AAAAAAAAGGTTACAACATCATGG	CTCTGTTCAATACTGT
AAAAAAAACCAAATAACATCATGG	CTCTGTTCAGATTCAT
AAAAAAAACTAAGTAACATCATGG	CTCTGTTCAGCATGTC
AAAAAAAAAAGACAAACATCATGG	CTCTGTTCATCCTAGA
AAAAAAAAGCCAGCAACATCATGG	CTCTGTTCATCGCTTT
AAAAAAAATAGGATGCTTGATTAC	CTCTTGATCCTTAGGG
AAAAAAAATTGTTGACTTGATTAC	CTCTTGATCTGGTCCT
AAAAAAAATTACCGGCTTGAATCT	CTGAATATCCCTCGCA
AAAAAAAACGGAGCACTTGAATCT	CTGAATATCCTAGTAA
AAAAAAAATCAGCACCTTGAATCT	CTGAATATCGAAGTAG
AAAAAAAAATAATGCGATCAAGAC	CTGACCAAGCAAGACA
AAAAAAAACTGATTTGATCAAGAC	CTGACCAAGCTTTGTT
AAAAAAAATCCGGTTGATCAAGAC	CTGACCAAGTGCTGTG
AAAAAAAATATCAGGGATCAAGAC	CTGACCAAGTTACCGG
AAAAAAAAACATTAGGATCAAGAC	CTGACCAAGTTCCCGT
AAAAAAAAGCAGTTAACGACTAGT	CTGATCACAACTAGAA
AAAAAAAACCATTGTACGACTAGT	CTGATCACATAAGGAC
AAAAAAAATACAAGCGACGAAGGA	CTGCAATAGCGCTCAA
AAAAAAAAGCTTATCGACGAAGGA	CTGCAATAGGAGTCTT
AAAAAAAACCTGCAACTGACCGAA	CTGCTACTCATTGACA
AAAAAAAAAAATACGCTGACCGAA	CTGCTACTCTAACTGA
AAAAAAAACCGCCTAACTTCAACC	CTGCTCCCACTAAGCC
AAAAAAAAACACCAAACTTCAACC	CTGCTCCCAGGTTATT
AAAAAAAAGTTGCAGGAGAGGCTT	CTGGACCAGGCGAATA
AAAAAAAACCCTAAGCTACCTAAC	CTGGATGTCTCAATTC
AAAAAAAAGACGAGGGACCGTTAC	CTGGCTAAGCATGTCG
AAAAAAAAATTTCGCGACAGCCTT	CTGGTCAAGCAAGGAC
AAAAAAAAAGTTAACGACAGCCTT	CTGGTCAAGGAACGGT
AAAAAAAACATGATGGACAGCCTT	CTGGTCAAGGCCTTAG
AAAAAAAACTAGTTTGACAGCCTT	CTGGTCAAGGTGCTGC
AAAAAAAAGGTAACTACGGTACTA	CTGGTTACAACAGGAT
AAAAAAAATTACCCAACGGTACTA	CTGGTTACATTATGAC
AAAAAAAATGGGCAATGGTCAGTC	CTGGTTTGTCATCATC
AAAAAAAAGCTGAGGTGGTCAGTC	CTGGTTTGTGAAGCCT
AAAAAAAACTTTGTTTGGTCAGTC	CTGGTTTGTTCGGTAA
AAAAAAAAATGACAGTGGTCAGTC	CTGGTTTGTTTATGGG
AAAAAAAATGAACGGTGGTCAGTC	CTGGTTTGTTTCCGGC
AAAAAAAAGTTTGTCGAAACGATT	CTGTAACAGAAAGCAT
AAAAAAAAGTTAGGCGAAACGATT	CTGTAACAGCAGGTTT
AAAAAAAAAGGGACGGAAACGATT	CTGTAACAGGATGATG
AAAAAAAAGCGCAATGAAACGATT	CTGTAACAGGGTGGAT
AAAAAAAAGCTTGAGGAAACGATT	CTGTAACAGGTCCTAG
AAAAAAAATGCTATACTCTCTAGG	CTGTATTTCAGCTAAC
AAAAAAAACCTTGAGCTCTCTAGG	CTGTATTTCATAATCG
AAAAAAAAGCGGTAACTCTCTAGG	CTGTATTTCATGGTTA
AAAAAAAAGTGAGCACTCTCTAGG	CTGTATTTCATGTCAA
AAAAAAAATGTTCCTCTCTCTAGG	CTGTATTTCTGTTGCC
AAAAAAAAAACTAACGAAGGTGGG	CTGTGTGAGTCACGAT
AAAAAAAATAAGCACGAAGGTGGG	CTGTGTGAGTTAGTGC
AAAAAAAATGGTCAAGAAGGTGGG	CTGTGTGAGTTTGCGG
AAAAAAAACGTAGTAGAGCTTTGT	CTGTTAAAGGATAAAC
AAAAAAAATAAGGCTGAGCTTTGT	CTGTTAAAGGTTTGCG
AAAAAAAAGCTATGGGAGCTTTGT	CTGTTAAAGTAGCTTA
AAAAAAAACATCCGTGAGCTTTGT	CTGTTAAAGTTTCCTG
AAAAAAAAACGTATTTGGCGAGTG	CTGTTTAGTACCGTTT
AAAAAAAAAGCCACTTGGCGAGTG	CTGTTTAGTGAGCGAA
AAAAAAAATGATCAGGACAAACTG	CTTAACAAGAATCGCT
AAAAAAAACGCTTGTGACAAACTG	CTTAACAAGTAACGGA
AAAAAAAACAATACCTGACGAAGT	CTTAAGGGTCAGGAAG
AAAAAAAATAATCCGTGACGAAGT	CTTAAGGGTTAACAGT
AAAAAAAATGTTGGTTGATTCAGT	CTTACCGGTGCATTAG
AAAAAAAATCCCTCTACCAGTATA	CTTACCTCAATCATGT
AAAAAAAAGTCACCATGGCTAGAA	CTTACTAGTGACATAT
AAAAAAAACGTCAATTGTCACGCG	CTTAGGAGTAGCTAGC
AAAAAAAAAGCCAAATGTCACGCG	CTTAGGAGTTCTTTAG
AAAAAAAATGTTGCGCTGACCATT	CTTAGTTTCTAGCGTG
AAAAAAAATACGTTACTTATGTTG	CTTATGTTCAAACTCA
AAAAAAAAAACCAGGCTTATGTTG	CTTATGTTCCGCCAAA
AAAAAAAATACCTCCTGAGTGATG	CTTATTGGTTAGACCA
AAAAAAAAACACCAAACTTAATGG	CTTCAAGCAGGTTATT
AAAAAAAATTTGTGCACTTAATGG	CTTCAAGCATAGGCGA
AAAAAAAAGTTAACCCTAGGCCCT	CTTCAATTCATTACTC
AAAAAAAACAATTGAACCAGGAAA	CTTCACTCAACAACAA
AAAAAAAATGAATTGACCAGGAAA	CTTCACTCAATAATGG
AAAAAAAATACTGAGGATAGACCA	CTTCAGGAGCACAGCC
AAAAAAAAGGAACAAGATAGACCA	CTTCAGGAGCACTTGG
AAAAAAAATCCGCATGATAGACCA	CTTCAGGAGGTAACGA
AAAAAAAAGATTGCGGATAGACCA	CTTCAGGAGTGAACAG
AAAAAAAAGCGCTAGACATGCAAC	CTTCATCCAAGGTACG
AAAAAAAAAGTACTGACATGCAAC	CTTCATCCATTATCCC
AAAAAAAACCTTGAGCTTAGTTGT	CTTCGCGTCATAATCG
AAAAAAAATCCAATACTTAGTTGT	CTTCGCGTCTAATCAG
AAAAAAAAAGGCGCATGTAAGCGG	CTTCTAAGTATTTGGG
AAAAAAAAATGCTTCGACTATGGA	CTTGAACAGCTCCTTA
AAAAAAAAGTCACAGGACTATGGA	CTTGAACAGGACGTAA
AAAAAAAATTCGCGCACCGGCCTT	CTTGAATCAAACCTAT
AAAAAAAAATTGTTCACCGGCCTT	CTTGAATCAAGGTATA
AAAAAAAACCTCAATACCGGCCTT	CTTGAATCACAGCCTG
AAAAAAAATGCACTTACCGGCCTT	CTTGAATCAGAGGCTA
AAAAAAAACTAACCTACCGGCCTT	CTTGAATCATGATTGT
AAAAAAAACTATTGTGAAAGCAAG	CTTGACGAGACTAAGG
AAAAAAAAGCATAATGAAAGCAAG	CTTGACGAGGATCACT
AAAAAAAAAATTGTGGAAAGCAAG	CTTGACGAGGTCCAAT
AAAAAAAATCGGTTTACGGATTTG	CTTGCAACACAGGGAC
AAAAAAAAGCTCGTTACGGATTTG	CTTGCAACACCTATAG
AAAAAAAAGGAAGCAACGGATTTG	CTTGCAACACTAAGTT
AAAAAAAAACGGTTCTGAATCTCA	CTTGCATGTAGCTAAT
AAAAAAAACAGATTCTGAATCTCA	CTTGCATGTCTTGCAT
AAAAAAAATATCCTAGAGTTGCCC	CTTGCTCAGACTCGCA
AAAAAAAAGCGGTTGACAAACCGT	CTTGGACCAAGGAATC
AAAAAAAAGTTTGTCGAGCTTGCC	CTTGTCCAGAAAGCAT
AAAAAAAAAAATGCTGAGCTTGCC	CTTGTCCAGAGAGGAG
AAAAAAAAGAATTTGGAGCTTGCC	CTTGTCCAGCATTTCT
AAAAAAAATCATCATGAGCTTGCC	CTTGTCCAGTCATTGA
AAAAAAAAGCACCTTACAAGCTCA	CTTGTTCCAATTGACT
AAAAAAAACGAGGTTACAAGCTCA	CTTGTTCCACAACCTA
AAAAAAAAGCTACTCACAAGCTCA	CTTGTTCCACTGACCG
AAAAAAAACAAGGCTACAAGCTCA	CTTGTTCCAGCATGGA
AAAAAAAACCGGATAACAAGCTCA	CTTGTTCCATGAATAG
AAAAAAAAAGGATAAACAAGCTCA	CTTGTTCCATGTTTGG
AAAAAAAACTGGCTTGAAAGGCCT	CTTGTTTAGATTGAGG
AAAAAAAACTAGTAGGAAAGGCCT	CTTGTTTAGCCGGTAC
AAAAAAAATCAACAAACTTGACCT	CTTTAGGCAAACTGTT
AAAAAAAAGATTGCAACTTGACCT	CTTTAGGCAATTAAGG
AAAAAAAACCAATATCTTTCATCC	CTTTAGTTCCTAATGA
AAAAAAAAATTTGCGCTTTCATCC	CTTTAGTTCCTTTACG
AAAAAAAAGACCTGCCTTTCATCC	CTTTAGTTCTAGCGAT
AAAAAAAACTTTAGGTGGATTCAT	CTTTATGGTAAGCTTG
AAAAAAAAGGCATGGTGGATTCAT	CTTTATGGTCATAGAT
AAAAAAAAAGTAACGTGGATTCAT	CTTTATGGTCTAGCTT
AAAAAAAACTAATGCTGGATTCAT	CTTTATGGTGGCTTCC
AAAAAAAATGACAAATGAGCTTGC	CTTTCTTGTTTAACGG
AAAAAAAAGGAAGCAACGGTCAGC	CTTTGAGCACTAAGTT
AAAAAAAAGCCATCATGGATTACT	CTTTGGTGTAGTAAGA
AAAAAAAATAGAAACTGGATTACT	CTTTGGTGTCGACTAA
AAAAAAAATAGTCAAACCCAAACG	CTTTGTCCACATGCTA
AAAAAAAAATATGCGACCCAAACG	CTTTGTCCAGCAAGGC
AAAAAAAACGCGAAATGGGTTAGA	GAAACCCGTACCTTAC
AAAAAAAAGACATCCTGGGTTAGA	GAAACCCGTCTAACAG
AAAAAAAACGTGCTGTGGGTTAGA	GAAACCCGTTTAGCGA
AAAAAAAAAGTGTGCGAAGGCTGT	GAAACTGAGCTTACTT
AAAAAAAAGTAACGCGATAACTTC	GAAAGCCAGCCTCTGT
AAAAAAAACCATCACGATAACTTC	GAAAGCCAGCTACTGG
AAAAAAAACCACAGGGACTAGGAT	GAACACAAGCTCATAA
AAAAAAAAGGGCTATGACTAGGAT	GAACACAAGGTGAAGC
AAAAAAAAGTAACGCGACCTCAAC	GAACCAAAGCCTCTGT
AAAAAAAACGCTTGTGACCTCAAC	GAACCAAAGTAACGGA
AAAAAAAATAGCCCTGACCTCAAC	GAACCAAAGTGAACCT
AAAAAAAAAACGGGAACGCAATCA	GAACCAGCAACTAACT
AAAAAAAAACGGCTCCTATGGATA	GAACCGCTCAAAGGCA
AAAAAAAAAGCTTGTCTATGGATA	GAACCGCTCATTCATC
AAAAAAAAAACGGACCTATGGATA	GAACCGCTCCTAGTTT
AAAAAAAATTTAGTGCTATGGATA	GAACCGCTCTAAGTCA
AAAAAAAAGCTATGTCTTAGCGCT	GAACCTGTCTTTGAGA
AAAAAAAAGTAATTGGATGCAAGT	GAACCTTAGGCGCTTA
AAAAAAAATAAGGTGCTCACTATA	GAACTTATCCTCACAC
AAAAAAAAAAGCTAACTCACTATA	GAACTTATCGCAAACT
AAAAAAAACACTATACTCACTATA	GAACTTATCTGGCATG
AAAAAAAAGTCAATAGACAAAGTC	GAAGCTAAGCGCCTTT
AAAAAAAACCCGGTTACCCGCCAT	GAAGGAACAGGCTTCG
AAAAAAAAGAAAGGCACCCGCCAT	GAAGGAACATCCAGGT
AAAAAAAATCACCATACCTAGTAA	GAAGGCCCAAGACTCC
AAAAAAAAAGTCCTCACCTAGTAA	GAAGGCCCAAGTGAAC
AAAAAAAACCTCGCAACCTAGTAA	GAAGGCCCATGTCAAT
AAAAAAAAAAATTGCGAACCGCAA	GAAGGCTAGTTATCTC
AAAAAAAAACCTACGTGGTTCAAT	GAAGTAAGTTCCTCCT
AAAAAAAACAATTGGGATAGACTG	GAAGTCAAGCATGCAT
AAAAAAAAGATGGCTGATAGACTG	GAAGTCAAGGACACTT
AAAAAAAACTATTAGCTTTAGCGC	GAAGTGATCCAAGTTA
AAAAAAAACGCAAGGCTTTAGCGC	GAAGTGATCTGCAACG
AAAAAAAAGTGCAAGCTGGTCAAG	GAATTTGTCCGCCTAT
AAAAAAAAAGAAAGGCTGGTCAAG	GAATTTGTCTCACTCA
AAAAAAAAGAAACTCACCCGCTAC	GACAATACACCTCAGG
AAAAAAAAGCTACTCACCCGCTAC	GACAATACACTGACCG
AAAAAAAATCTTAGTGAACTTAAG	GACATAGAGCAATAGG
AAAAAAAATTACCCGGAACTTAAG	GACATAGAGTGAGAGC
AAAAAAAATGTATTGCTGGACGTA	GACATTATCATCACTT
AAAAAAAATTAAAGCACAAACGGG	GACCGAACATAATCCG
AAAAAAAAAGAACCTACTCACCTA	GACCGTTCAATAATCC
AAAAAAAATTCACTTTGATCAGCC	GACCTAAGTTAGCCAA
AAAAAAAATCCACAATGATCAGCC	GACCTAAGTTTGCTGT
AAAAAAAAGCGAGAGGATCAGCAA	GACCTCAAGGTTACAC
AAAAAAAATTCAGTACTAATCGGG	GACCTGATCCCTGGTT
AAAAAAAAGTACAATGACCTTTGG	GACCTGCAGATTCCTT
AAAAAAAAGAACTGATGATGCACC	GACCTTTGTGATGATT
AAAAAAAAACACCGTTGATGCACC	GACCTTTGTTATTGCC
AAAAAAAAATGCGCTTGATGCACC	GACCTTTGTTCCAGGG
AAAAAAAACCGTTTAACAAGCCTA	GACGCAACACTGACTA
AAAAAAAAAGGGTGGGAATAATCG	GACGCCTAGAATGACG
AAAAAAAAGAAGTTTGATAGCCAA	GACGTAAAGCATGTTA
AAAAAAAAAGAATCGTGGTACACC	GACTAATGTACCGGAT
AAAAAAAACCTTTATTGGTACACC	GACTAATGTCATCCTG
AAAAAAAAGACACCTTGGTACACC	GACTAATGTTTGGGCG
AAAAAAAAATGTTTCACCTGCGAA	GACTATTCAGCTACGT
AAAAAAAAGCAACATACCTGCGAA	GACTATTCAGTGAACG
AAAAAAAACACGGATACGGAGCAA	GACTCACCAGGAATCG
AAAAAAAAGTGAACCGACTTGGTC	GACTTACAGCAAACCT
AAAAAAAATCCACCTTGATCCTAA	GACTTAGGTAAGGTTT
AAAAAAAAATGACTCCTTTGCTCT	GACTTGGTCATAACGC
AAAAAAAACTATAACCTTTGCTCT	GACTTGGTCATTGCAA
AAAAAAAACCTAAGCCTTTGCTCT	GACTTGGTCTAACCAA
AAAAAAAATTTAAGCCTTTGCTCT	GACTTGGTCTTGAGGT
AAAAAAAAATGTTGTTGTAGCCTA	GAGATAAGTTACATCC
AAAAAAAACAACCTGCTTAGAAGC	GAGCAAATCGCGACAC
AAAAAAAAAGTGAGGACACGCGGT	GAGCATGCAATAGCAA
AAAAAAAAACGCAATACACGCGGT	GAGCATGCACAACAGG
AAAAAAAAAGTACTGACACGCGGT	GAGCATGCATTATCCC
AAAAAAAAAACCTGTCTATGACAA	GAGCCACTCCCTCATA
AAAAAAAACAGAGGGACCGGCTCT	GAGCCTTCAGTTAGCC
AAAAAAAAGATGACATGGAGGAAG	GAGCGAAGTAATAACC
AAAAAAAAGCTATACCTCGCTTGA	GAGCTGCTCCTGTTCA
AAAAAAAACGGCTCATGCCTTTAT	GAGCTTAGTAATAGCT
AAAAAAAATGCTTAGTGCCTTTAT	GAGCTTAGTCAACAAT
AAAAAAAACTTAGGCCTAGAGGCT	GAGCTTGTCAATCTCT
AAAAAAAAGGCTAAGCTAGAGGCT	GAGCTTGTCATCAGTA
AAAAAAAAAATAAGCCTAGAGGCT	GAGCTTGTCCCTCACG
AAAAAAAAATGCATAGAGCAATTA	GAGGACTAGGACAACA
AAAAAAAAGCAACGGTGTCCAGCG	GAGGCAAGTATCTGGA
AAAAAAAAGATCCTACTAAATAGC	GAGGCCTTCAATTGGC
AAAAAAAAAGTCCTCACGCCTCTA	GAGGCTACAAGTGAAC
AAAAAAAATGGTGTGACGCCTCTA	GAGGCTACACAAAGGT
AAAAAAAAAGCTGTAACGCCTCTA	GAGGCTACACGTTACA
AAAAAAAACGTAAATACGCCTCTA	GAGGCTACAGCTAATT
AAAAAAAAGGTGTTAACGCCTCTA	GAGGCTACAGGTTAAA
AAAAAAAAATAACCGACGCCTCTA	GAGGCTACAGTTTGGC
AAAAAAAAAGGATAAACGCCTCTA	GAGGCTACATGTTTGG
AAAAAAAAGGGTAATTGTCATCCC	GAGGCTTGTTCAAGAT
AAAAAAAATTGCTTAGACCTTACG	GAGGTACAGACAAAGT
AAAAAAAATCACCTGGACCTTACG	GAGGTACAGCTATTGA
AAAAAAAAGGGTACTGACCTTACG	GAGGTACAGGGATTAG
AAAAAAAAAGCGAGGGACCTTACG	GAGGTACAGGTAAGGC
AAAAAAAACCAATACTGTGAGCAG	GAGGTAGGTATGGTGC
AAAAAAAATGCAAGGTGTGAGCAG	GAGGTAGGTTAGCGTA
AAAAAAAATCCGTAATGTGAGCAG	GAGGTAGGTTCACCAT
AAAAAAAAGTTTCCAGAGAAGCAA	GAGGTTAAGCTGGCTA
AAAAAAAAAGTGTGCGAGAAGCAA	GAGGTTAAGCTTACTT
AAAAAAAACTAGGCGGAGAAGCAA	GAGGTTAAGGGACTAA
AAAAAAAATAGGTACGAGAAGCAA	GAGGTTAAGGTAAGCA
AAAAAAAAGCCATAAACTTGCTCA	GAGTAACCACCTGTAA
AAAAAAAACCCTCCTGATTGCGCT	GAGTAATAGACACCGC
AAAAAAAACTGGCAGGATTGCGCT	GAGTAATAGCCTCTCG
AAAAAAAAATGGATTGATTGCGCT	GAGTAATAGGCCCAGT
AAAAAAAACAGCTACCTATGTGGG	GAGTATCTCCCGTTGT
AAAAAAAATTTAAGCCTATGTGGG	GAGTATCTCTTGAGGT
AAAAAAAAGACCAAGCTACTGAAA	GAGTCATTCCATTACT
AAAAAAAACTGCCAGTGAGTTACT	GAGTGAGGTAACGGGA
AAAAAAAACCGGTTCACGCAATGT	GAGTGATCAGTAAGTA
AAAAAAAAGCAATTGACGCAATGT	GAGTGATCATTGACAT
AAAAAAAATCCGGTACTTAGCTCG	GAGTGTTTCAATCATG
AAAAAAAAGATATAGCTTAGCTCG	GAGTGTTTCATTAGCA
AAAAAAAAGGGAGGACTTAGCTCG	GAGTGTTTCTCACATT
AAAAAAAATCCAGCACTCGATATT	GAGTTACTCCTAACGG
AAAAAAAAGAATTGACTCGATATT	GAGTTACTCTCATCAT
AAAAAAAAAGTTAGGTGGCTTGAC	GAGTTTGGTATTTGCC
AAAAAAAATGGAGCATGGCTTGAC	GAGTTTGGTCATTGAG
AAAAAAAAGTAGTCCTGGCTTGAC	GAGTTTGGTGCAATGC
AAAAAAAACCTAGCGTGGCTTGAC	GAGTTTGGTTAGGACC
AAAAAAAATAGCTCATGGATGACA	GATAAAGGTAGCCTCC
AAAAAAAACGCAACCTGGATGACA	GATAAAGGTAGCTGGT
AAAAAAAACGATTAGGAACGGTGT	GATAACGAGCTTGCTC
AAAAAAAAGTAATCGACGTAATGC	GATAAGCCAACAGCCT
AAAAAAAAAAGCCTAACGTAATGC	GATAAGCCATATAACC
AAAAAAAACTCATTGACTGGTCAG	GATAGACCAAATACCT
AAAAAAAAGTTGTCCACTGGTCAG	GATAGACCAGCGCTTG
AAAAAAAAGCTACAAACTGGTCAG	GATAGACCAGGCTACT
AAAAAAAACGCTAAAGACGCAAGC	GATCAAGAGACAACGA
AAAAAAAATAACCTTGACGCAAGC	GATCAAGAGGAACCAA
AAAAAAAAGTTAGCGGATTCCCAG	GATCACTAGCTTAGTA
AAAAAAAAGCTTTGTGATTCCCAG	GATCACTAGTCATGCG
AAAAAAAAGCTTCATGATTCCCAG	GATCACTAGTTATTCC
AAAAAAAAACCAGGTGATTCCCAG	GATCACTAGTTGTCAA
AAAAAAAATCACGTTACGTTATGG	GATCAGGCAATCCCTT
AAAAAAAAATCGCGCCTAAATCCC	GATCAGTTCACCTGCT
AAAAAAAATTCGCGCACGAAGGAC	GATCCGTCAAACCTAT
AAAAAAAATCCTCCTACGAAGGAC	GATCCGTCATAATCAC
AAAAAAAACACACCCACTTAACGA	GATCGAGCACAATTAC
AAAAAAAACCTTGTTCTAAACCCT	GATCGATTCATCCTCA
AAAAAAAACCAAGGTACATCCACC	GATCGCTCACAGCCAT
AAAAAAAAGGTACGCACATCCACC	GATCGCTCACTTCACT
AAAAAAAATGCCAGAACATCCACC	GATCGCTCAGCAACCT
AAAAAAAAGTGGACACTCCGCTAA	GATGACTTCACTTCAT
AAAAAAAAATTCCTTCTCCGCTAA	GATGACTTCTCGCCCA
AAAAAAAATAGGAGTCTTGAGGCG	GATGCATTCACTAATG
AAAAAAAAGATACTCCTTGAGGCG	GATGCATTCCGCAACA
AAAAAAAAAGACTTAGATCCCTGA	GATGCTTAGTGCACGC
AAAAAAAAACAACATGAGCATGCA	GATGGACAGAGAGGCT
AAAAAAAATCGTACCGAGCATGCA	GATGGACAGCCAAATC
AAAAAAAACGTTATGTGATGATGG	GATGGCTGTAATCGTG
AAAAAAAACGCTAATTGATGATGG	GATGGCTGTCCTTCTC
AAAAAAAACTTAGTGTGATGATGG	GATGGCTGTGAAACAA
AAAAAAAATCCGTAATGATGATGG	GATGGCTGTTCACCAT
AAAAAAAATAGAATCACGAGGAAC	GATTAAGCAGTAATAG
AAAAAAAACCACTATACGAGGAAC	GATTAAGCAGTCTAGC
AAAAAAAATCAGGACACTAAGCAT	GATTACTCAATAGTCT
AAAAAAAAATGAGAAACTAAGCAT	GATTACTCACAATACT
AAAAAAAAACCGGACACTAAGCAT	GATTACTCATTAGGCC
AAAAAAAATTGAAGGCTGATTTGC	GATTAGCTCGCCTGTT
AAAAAAAAGTTGTTGCTGATTTGC	GATTAGCTCGTTCACC
AAAAAAAAGATAGACTGCGGATAG	GATTAGTGTATTGTGG
AAAAAAAAGTTTAGCCTGACCAAG	GATTATGTCCATCAGG
AAAAAAAATGCTGTGCTGACCAAG	GATTATGTCCTGATTT
AAAAAAAATAGCCACCTGACCAAG	GATTATGTCGATTTGA
AAAAAAAATTGCCAGCTGACCAAG	GATTATGTCGCTAAGT
AAAAAAAATGTCCTTCTGACCAAG	GATTATGTCTACTAAG
AAAAAAAACGATAAGCTTGCATAT	GATTCAATCCCATAGG
AAAAAAAATAGGTGACTTGCATAT	GATTCAATCTTGAGCG
AAAAAAAACTTTAGGTGACTATGT	GATTCAGGTAAGCTTG
AAAAAAAAATGACTTTGACTATGT	GATTCAGGTTATCCGT
AAAAAAAAGATGACTACTTGGATA	GATTCATCATAGCAGG
AAAAAAAACTGACCGTGGCGGTTT	GATTCCTGTAAAGCGG
AAAAAAAAATGTTGTTGGCGGTTT	GATTCCTGTTACATCC
AAAAAAAACAACATAACATAGCTG	GATTCGCCAGGAACCA
AAAAAAAAAGTACTGACATAGCTG	GATTCGCCATTATCCC
AAAAAAAACTAGGCCTGCTGGCCA	GATTGATGTCACTCGC
AAAAAAAATCTTTGTTGCCGCACA	GATTGCAGTCTCAGCC
AAAAAAAAGATGACATGTGGTTAC	GATTGGCGTAATAACC
AAAAAAAAAAGCATGTGTGGTTAC	GATTGGCGTTTGGCGG
AAAAAAAAGGCTTTACTGTTGTCA	GATTGGTTCCTCAGCT
AAAAAAAAGTCAAGCGATCATATC	GCAAACAAGACTTATG
AAAAAAAAGTAACGCGATCATATC	GCAAACAAGCCTCTGT
AAAAAAAAAGAGGCGGATCATATC	GCAAACAAGGCCTAAT
AAAAAAAAAATTACGGATCATATC	GCAAACAAGTAACCCG
AAAAAAAAAGGCGCATGTTGGAGG	GCAAACCGTATTTGGG
AAAAAAAATGCATTACTTGACCTG	GCAAACTTCAGCAAAG
AAAAAAAATCTTGCTCTTGACCTG	GCAAACTTCAGTTCCC
AAAAAAAAAACTAAGCTTGACCTG	GCAAACTTCGGGATTT
AAAAAAAATATTAGCCTTGACCTG	GCAAACTTCTATCGCC
AAAAAAAACGTACTTACCTGCAAG	GCAACAGCAAATTGCT
AAAAAAAATCCAGGAACCTGCAAG	GCAACAGCATCACAGC
AAAAAAAACACATAAACCTGCAAG	GCAACAGCATGAATCT
AAAAAAAATGAGTGACTAGTCGAG	GCAAGCCTCCTGGCTT
AAAAAAAATTACAACCTAGTCGAG	GCAAGCCTCCTGGTCT
AAAAAAAATAGGTAGCTAGTCGAG	GCAAGCCTCTAATCTC
AAAAAAAAGCGCAATGATCCAGGG	GCAATAGAGGGTGGAT
AAAAAAAAAACGATTGATCCAGGG	GCAATAGAGGTTAGAG
AAAAAAAAACGTATTTGCAGGCCT	GCAATATGTACCGTTT
AAAAAAAATGTGATGGACAAGTGT	GCAATCTAGGCAATAG
AAAAAAAATAGCCCTGACAAGTGT	GCAATCTAGTGAACCT
AAAAAAAAAACGAATCTGTCCAGC	GCAATGTTCGCAACAT
AAAAAAAAGAAATACCTGTCCAGC	GCAATGTTCTGTGAGT
AAAAAAAACTAACAGGATATTTCG	GCACATTAGTGGCGGA
AAAAAAAACGTACTTACGGATTAC	GCACGAACAAATTGCT
AAAAAAAAGGTTAGTACGGATTAC	GCACGAACAATTGCGC
AAAAAAAAGCACGCAACGGATTAC	GCACGAACAGCAAATA
AAAAAAAACGCATCCACGGATTAC	GCACGAACAGTAGGAT
AAAAAAAAGATTACGACGGATTAC	GCACGAACATGTTGTG
AAAAAAAATTCTTGAGAGGATATT	GCACGCTAGATGGACA
AAAAAAAAAATCCGGGAGGATATT	GCACGCTAGTTAGACC
AAAAAAAACCAGAAACTCTAGGCT	GCACGGTTCCTAAGTA
AAAAAAAATGAATCTCTCTAGGCT	GCACGGTTCGGCCAGT
AAAAAAAACGGCTCATGCTATGTG	GCACTAAGTAATAGCT
AAAAAAAACGCCAACTGCTATGTG	GCACTAAGTCATTACC
AAAAAAAAATGCGCTTGCTATGTG	GCACTAAGTTCCAGGG
AAAAAAAATCGCTAATGCTATGTG	GCACTAAGTTTAACCC
AAAAAAAAGTCCGGAACGCCTACT	GCACTTACATGGCCTG
AAAAAAAAAGCCCTTACGCCTACT	GCACTTACATTCAGCA
AAAAAAAAATTGGGATGGCCAACT	GCAGCCAGTTGCGGAT
AAAAAAAATGTATTGCTTCAGGTC	GCAGCTATCATCACTT
AAAAAAAATAGGTTTCTTCAGGTC	GCAGCTATCGCTCACT
AAAAAAAATATTAGCCTTCAGGTC	GCAGCTATCTATCGCC
AAAAAAAATCAAACCTGGCGGAAC	GCAGGAAGTAGCTGCG
AAAAAAAATCATTTCTGGCGGAAC	GCAGGAAGTCCTTTAA
AAAAAAAAACCCGGAACATTGAGC	GCAGGACCAACCCTAA
AAAAAAAACTCCATAACATTGAGC	GCAGGACCAAGATTCT
AAAAAAAATCCGGAAACATTGAGC	GCAGGACCACATAACT
AAAAAAAAGTGAACCGAAGGCTAC	GCAGGATAGCAAACCT
AAAAAAAAGATGGCTGAAGGCTAC	GCAGGATAGGACACTT
AAAAAAAACACCAGGGAAGGCTAC	GCAGGATAGTAACTCA
AAAAAAAAGTACTGGGAAGGCTAC	GCAGGATAGTCTGGGC
AAAAAAAATCCTTAAGAGCTAGAC	GCAGGCAAGCACAGAA
AAAAAAAAGATAATCGAGCTAGAC	GCAGGCAAGTCACTAA
AAAAAAAACCTTGTTCTTGGTTAT	GCAGGCTTCATCCTCA
AAAAAAAATAAATCCCTTGGTTAT	GCAGGCTTCTTGTCTG
AAAAAAAAAGCACCTTGCAGGCAA	GCAGGTTGTGCTTAGA
AAAAAAAACCTTTGGGAGGGTTTG	GCATGAAAGAGAAGGG
AAAAAAAAAGAGGATGAGGGTTTG	GCATGAAAGCATGGTT
AAAAAAAAGAATTTGGAGGGTTTG	GCATGAAAGCATTTCT
AAAAAAAAGTAATGTGAGGGTTTG	GCATGAAAGGAGGACT
AAAAAAAACCGAAGCGAGGGTTTG	GCATGAAAGTTTGGTA
AAAAAAAAAGTACTGACTTGACGG	GCATGAGCATTATCCC
AAAAAAAACTCCTCATGATCCAAT	GCATTAGGTCACGAAC
AAAAAAAAAAGTAACCTTTGTGAT	GCCAACATCTTGATGA
AAAAAAAAGACAATGTGGCAATTT	GCCAATAGTTAACACG
AAAAAAAATGCAAGGTGGCAATTT	GCCAATAGTTAGCGTA
AAAAAAAAACAACTAGACCATATT	GCCAATTAGGAATAAC
AAAAAAAATTAGGACGACCATATT	GCCAATTAGGGTTATC
AAAAAAAACTTAGGCCTTAATTGC	GCCACAATCAATCTCT
AAAAAAAACCAACAAGAGGGAGCA	GCCACACAGCCACATG
AAAAAAAAAGAGCAAGAGGGAGCA	GCCACACAGGAAGTAT
AAAAAAAACGCTAAAGAACGGTAC	GCCACTAAGACAACGA
AAAAAAAAGTACAATGAACGGTAC	GCCACTAAGATTCCTT
AAAAAAAATTTCCGGGAACGGTAC	GCCACTAAGCCAGTAT
AAAAAAAAGCTCATTGAACGGTAC	GCCACTAAGGTAGCTT
AAAAAAAAGTAGTAACTACTCCTC	GCCAGGTTCCTACCTA
AAAAAAAAGTAATGACTACTCCTC	GCCAGGTTCGGTTTGG
AAAAAAAAGCCAACCCTAAAGCCG	GCCATGATCCATAATG
AAAAAAAATAGCTATCTAAAGCCG	GCCATGATCCGGCTAA
AAAAAAAAGAGAGCAACGAGGGAT	GCCATTACAGGACCTT
AAAAAAAAACGCGCAACGAGGGAT	GCCATTACATAGACTT
AAAAAAAAGGTTAACACGAGGGAT	GCCATTACATTATGCG
AAAAAAAAGCGCATCCTGAGTCTT	GCCCAAATCTAATCCT
AAAAAAAAATTGCTCGAGGTAGCT	GCCCATAAGCCATCAG
AAAAAAAAGGCTCCTGAGGTAGCT	GCCCATAAGTATTGTG
AAAAAAAAGGTTGCAGAGGTAGCT	GCCCATAAGTCAGTAC
AAAAAAAAGAAGAAATGATTTAGC	GCCCGTTGTACGTTTC
AAAAAAAACGCCAACTGATTTAGC	GCCCGTTGTCATTACC
AAAAAAAATAATCCGTGATTTAGC	GCCCGTTGTTAACAGT
AAAAAAAATCACGATTGATTTAGC	GCCCGTTGTTTACGTC
AAAAAAAAGTTGCTGTGGTTTATG	GCCGTGAGTATACTGG
AAAAAAAACTGGACGGACATCCTG	GCCTAATAGGCTAATC
AAAAAAAATTACCCGGACATCCTG	GCCTAATAGTGAGAGC
AAAAAAAACCAGAAACTCCACCTC	GCCTACTTCCTAAGTA
AAAAAAAAGAATTGACTCCACCTC	GCCTACTTCTCATCAT
AAAAAAAATTGCGCGTGTAACACC	GCCTATTGTCAATACG
AAAAAAAAAACTTGTTGTAACACC	GCCTATTGTGCTCCGT
AAAAAAAACGCTACGTGTAACACC	GCCTATTGTGTGCAAC
AAAAAAAACGTGCTGTGTAACACC	GCCTATTGTTTAGCGA
AAAAAAAATAGACCAGATCCTGTG	GCCTCAAAGCCTTAAA
AAAAAAAAGTCACAGGATCCTGTG	GCCTCAAAGGACGTAA
AAAAAAAAATTGTTCACCGTGCTC	GCCTCGACAAGGTATA
AAAAAAAAGATTACGACCGTGCTC	GCCTCGACATGTTGTG
AAAAAAAATAGTCTCACCGTGCTC	GCCTCGACATTAAGTC
AAAAAAAAAAGTGAGGACATATTC	GCCTGACAGACAAGTG
AAAAAAAAAGGCGCATGCTCACCT	GCCTGAGGTATTTGGG
AAAAAAAACGGAAACTGCTCACCT	GCCTGAGGTTAACGAT
AAAAAAAAGCACAAATGCTCACCT	GCCTGAGGTTGCATCT
AAAAAAAATGCTGTTACCCGGAAT	GCCTGTGCAAGGATTA
AAAAAAAAAATCGTGACCCGGAAT	GCCTGTGCAGTTTCTC
AAAAAAAAAAGAACAACAGATTGC	GCCTTAACAAACATAG
AAAAAAAAAACCATGACAGATTGC	GCCTTAACAAACGCGA
AAAAAAAAACTGACAACAGATTGC	GCCTTAACACAGGAAT
AAAAAAAATACGCACCTAGGCTAG	GCCTTACTCACTCAAA
AAAAAAAAATGAGGAGATTACGGA	GCCTTAGAGCATTATG
AAAAAAAATTTGCGCGATTACGGA	GCCTTAGAGTCTCACC
AAAAAAAACGCGAAATGCATTTGG	GCCTTGCGTACCTTAC
AAAAAAAAGTTGAAGTGCATTTGG	GCCTTGCGTTACCGGG
AAAAAAAAGACTAGGCTCCACAAC	GCCTTTATCCCGCCTA
AAAAAAAAGCTGTCATGAGCAAGT	GCCTTTGGTCAAGTAT
AAAAAAAATGGGCAATGAGCAAGT	GCCTTTGGTCATCATC
AAAAAAAAGAAGCTATGAGCAAGT	GCCTTTGGTGACCTGG
AAAAAAAATAGCTGAGAGCAACAC	GCGAGTGAGTCCTTCA
AAAAAAAACTTTAAGCTGACAGTG	GCGATATTCCAATTAG
AAAAAAAAGTGATCCTGGCCAGTT	GCGATTAGTGGGAACA
AAAAAAAACTGGCTTGAACCAAAT	GCGATTTAGATTGAGG
AAAAAAAATTACCCGGAACCAAAT	GCGATTTAGTGAGAGC
AAAAAAAAACCTTTAACGTTTCTA	GCGCAAACAGATAGAC
AAAAAAAATAAATGCACGTTTCTA	GCGCAAACAGGCCATT
AAAAAAAATCTAACCACGTTTCTA	GCGCAAACAGGCTAAG
AAAAAAAATTACCCAACGTTTCTA	GCGCAAACATTATGAC
AAAAAAAAAGTCCTCACCTGATAA	GCGCTTGCAAGTGAAC
AAAAAAAAATGAGAAACTCATAAG	GCGGAACCACAATACT
AAAAAAAATGCGCCTACTTAACAG	GCGGATACAATATACC
AAAAAAAAGATAGACTGACTAATC	GCGTAACGTATTGTGG
AAAAAAAATTTCCGGGAAATTGTG	GCGTGCTAGCCAGTAT
AAAAAAAATGCTATGTGGGCATGG	GCTAACAGTTTGGGTA
AAAAAAAATATGCTCACTTGTCCA	GCTAACCCAGGGAGCT
AAAAAAAAGAGAAGCACTTGTCCA	GCTAACCCATGTGGGA
AAAAAAAACCTTTGGGATTATCAC	GCTAAGAAGAGAAGGG
AAAAAAAACTATTTGGATTATCAC	GCTAAGAAGATGCCTG
AAAAAAAAGCACTAGGATTATCAC	GCTAAGAAGCTAATTG
AAAAAAAAGAATATCGATTATCAC	GCTAAGAAGTTAGCTA
AAAAAAAAGATTATCTGAGCGCGA	GCTAAGCGTTACAACG
AAAAAAAACTATAACCTAACTCAC	GCTAAGTTCATTGCAA
AAAAAAAAAAGCTAACTAACTCAC	GCTAAGTTCGCAAACT
AAAAAAAACTTCCCGCTATTGGCT	GCTAATATCGTCCTTA
AAAAAAAAGGTATTGACTAACCTC	GCTAGCTCACAAACTT
AAAAAAAATGCTACTACTAACCTC	GCTAGCTCATGCTCCC
AAAAAAAAAGCAATACTCATGACC	GCTAGTGTCAGCAAGA
AAAAAAAATATTGGCTGCTTATGG	GCTATAGGTCACAGAC
AAAAAAAATTTGCTCCTCCCGCTT	GCTATCCTCATAGCCG
AAAAAAAACTAGATTCTCCCGCTT	GCTATCCTCCGGGACT
AAAAAAAATCGTTAACTCCCGCTT	GCTATCCTCCGGTATG
AAAAAAAATTCGTAACTCCCGCTT	GCTATCCTCTATGACA
AAAAAAAATCCCTCTACAGCCGGT	GCTATTGCAATCATGT
AAAAAAAACCAAGGTACAGCCGGT	GCTATTGCACAGCCAT
AAAAAAAAAAGATAGACAGCCGGT	GCTATTGCAGCTTAGC
AAAAAAAATTAAAGCACAGCCGGT	GCTATTGCATAATCCG
AAAAAAAACGCTTTAACAGCCGGT	GCTATTGCATTGTGTG
AAAAAAAACCCAAATTGGCGCGAA	GCTCATTGTAAGGTCC
AAAAAAAAAGTCATTTGGCGCGAA	GCTCATTGTATGTGGC
AAAAAAAATCCTAAGTGGCGCGAA	GCTCATTGTTAACGGC
AAAAAAAAATGACTTTGGCGCGAA	GCTCATTGTTATCCGT
AAAAAAAAGTGGCCAACGGGCCAT	GCTCGATCAAGTTATC
AAAAAAAACAAACTAACGGGCCAT	GCTCGATCATGTCAGC
AAAAAAAAGGAATATCTAGCGGAT	GCTCTGTTCCAAACAC
AAAAAAAAGATGTAACTAGCGGAT	GCTCTGTTCTCCATGC
AAAAAAAAACAAGCGCTGTGAGAC	GCTGACATCAATAGCC
AAAAAAAATACATACCTGTGAGAC	GCTGACATCGAGCTAT
AAAAAAAAGCAAATACTGTGAGAC	GCTGACATCTCGACCT
AAAAAAAAGATTCAAGATTCCTCT	GCTGACCAGGCAAGTA
AAAAAAAAGGAGGGTGATTCCTCT	GCTGACCAGGGCCATC
AAAAAAAAAGCAATTGAAGGAATG	GCTGAGGAGTCTATGA
AAAAAAAAGGCATTTCTAGCCAGA	GCTGCAATCATTAGTG
AAAAAAAACGCTTAGCTAGCCAGA	GCTGCAATCCTTCTAG
AAAAAAAATCTAGCGCTAGCCAGA	GCTGCAATCGCGCTAA
AAAAAAAAGGAGAAACTAGCCAGA	GCTGCAATCGGTTTCC
AAAAAAAACTTAATGCTAGCCAGA	GCTGCAATCTTAGGGT
AAAAAAAATACCGCACTAGCCAGA	GCTGCAATCTTGTCCA
AAAAAAAAGATCAGTACTCAATGA	GCTGCATCATTAGCGC
AAAAAAAAATGGGCGTGGACTAAG	GCTGGATGTAGGTGTC
AAAAAAAAGTTGAAGTGGACTAAG	GCTGGATGTTACCGGG
AAAAAAAACGATTCATGGACTAAG	GCTGGATGTTACCTGT
AAAAAAAAAGGGATTTGGACTAAG	GCTGGATGTTGTAAAC
AAAAAAAACCTTATTTGAGCCACT	GCTGTAAGTTGTTCAC
AAAAAAAATTACCCAACGCCACTT	GCTGTACCATTATGAC
AAAAAAAATACGTTACTTAGGTAG	GCTGTGATCAAACTCA
AAAAAAAAATAGCTCCTTAGGTAG	GCTGTGATCCTTAATC
AAAAAAAAGTTAAAGCTTAGGTAG	GCTGTGATCTCGCCTG
AAAAAAAACGAGTTAGAACCTTTG	GCTGTGCAGCACGATT
AAAAAAAAGGTTGTTCTCGATAAG	GCTTAAATCCAACTGG
AAAAAAAACATGTTTGATTGAGGT	GCTTAACAGTCCTGAG
AAAAAAAATTCGTAACTTTGTGGC	GCTTACCTCTATGACA
AAAAAAAATACCGCACTTTGTGGC	GCTTACCTCTTGTCCA
AAAAAAAAACAACTAGACTTAATC	GCTTAGTAGGAATAAC
AAAAAAAATGGTCCTGACTTAATC	GCTTAGTAGGCAACAA
AAAAAAAATCGATCATGAGTGAGT	GCTTATCGTCCACAAA
AAAAAAAACTTCATTTGGGTGTAA	GCTTCGCGTCCCGGAA
AAAAAAAAGCACAAATGAAGCCAA	GCTTGTTGTTGCATCT
AAAAAAAAGTCTAGCTGTTTCAGG	GCTTTACGTGGATGTC
AAAAAAAACAAGCTCCTCCATAAT	GCTTTATTCCATAAGC
AAAAAAAACTTGAATCTCCATAAT	GCTTTATTCCCGCAAA
AAAAAAAATCCAGCACTCCATAAT	GCTTTATTCCTAACGG
AAAAAAAAATAGATGCTCCATAAT	GCTTTATTCTACCTGC
AAAAAAAAGGTTGCGACTTCGTCA	GGAAACTCACCCACAG
AAAAAAAATGACAATACTTCGTCA	GGAAACTCACCTCACC
AAAAAAAACAGAGGGACTTCGTCA	GGAAACTCAGTTAGCC
AAAAAAAACGGCCTTACTTCGTCA	GGAAACTCATAAGCAA
AAAAAAAAGACCTGCCTTAGGCGG	GGAACAATCTAGCGAT
AAAAAAAACAACAGCACATGAAAG	GGAACCACAATAACGA
AAAAAAAACAAACAATGCCTATTT	GGAACCTGTGTCCAAA
AAAAAAAAGGCTTCGCTTGCTGCA	GGAACGGTCCTAGTCC
AAAAAAAACAATTGGGAGTCTTAC	GGAAGCTAGCATGCAT
AAAAAAAAACTAAAGCTATCCTAG	GGAAGTATCATTTGCT
AAAAAAAATTGCCAGCTATCCTAG	GGAAGTATCGCTAAGT
AAAAAAAAAGAACCGCTATCCTAG	GGAAGTATCTCACACC
AAAAAAAATGCATTACTCAATTAC	GGAATCTTCAGCAAAG
AAAAAAAATTACCTCCTCAATTAC	GGAATCTTCATTGTTC
AAAAAAAAATAGTGACTCAATTAC	GGAATCTTCCGCATGA
AAAAAAAAGTTCACTGATTAGGCA	GGACCGAAGCATGAAG
AAAAAAAAGGAGCTTGATTAGGCA	GGACCGAAGTCATTTC
AAAAAAAAGCTAAATGAGTATGTA	GGACCTCAGATAACCC
AAAAAAAACTTTAACGAGTATGTA	GGACCTCAGCTATATG
AAAAAAAACCACAGGGAGTATGTA	GGACCTCAGCTCATAA
AAAAAAAAATTGTGCCTGCTAATC	GGACGGATCCCAGTAG
AAAAAAAATATTAGCCTGCTAATC	GGACGGATCTATCGCC
AAAAAAAAGGTTAATGACTTAGAG	GGAGGTTAGAACCTAC
AAAAAAAAGGAACCTGACTTAGAG	GGAGGTTAGGATTGAG
AAAAAAAACAGGAACTGTTCCCGT	GGAGTCTGTACTGATG
AAAAAAAAGCAACGGTGTTCCCGT	GGAGTCTGTATCTGGA
AAAAAAAATTACTGCACAGATAAG	GGATAACCAGTATGTT
AAAAAAAACTTACGTACAGATAAG	GGATAACCATCCGTAA
AAAAAAAACCGGATAACAGATAAG	GGATAACCATGAATAG
AAAAAAAAAGTACTGACAGATAAG	GGATAACCATTATCCC
AAAAAAAACTATTGACTGCCACAC	GGATACTTCCTAAGAC
AAAAAAAACCAATATCTGCCACAC	GGATACTTCCTAATGA
AAAAAAAATTACTCCCTGCCACAC	GGATACTTCTAGCTTT
AAAAAAAACTGAGGATGAGCGATA	GGATATTGTAATGACT
AAAAAAAAATGGGCGTGAGCGATA	GGATATTGTAGGTGTC
AAAAAAAATGCTTAGTGAGCGATA	GGATATTGTCAACAAT
AAAAAAAAATTTGGTTGAGCGATA	GGATATTGTCAGTAAT
AAAAAAAACCATGACCTTACGTGC	GGATGAATCATGCAAC
AAAAAAAAAGCTTGTCTTACGTGC	GGATGAATCATTCATC
AAAAAAAAGCAGTTAACTCAGGCA	GGATGGCCAACTAGAA
AAAAAAAAAGCCCTTACTCAGGCA	GGATGGCCATTCAGCA
AAAAAAAACACAGGCGAGCAATAT	GGATGTAAGGACTTAC
AAAAAAAACAATCCATGAGGTTAG	GGATTGCGTCCAAATG
AAAAAAAACGCATTATGAGGTTAG	GGATTGCGTGGATTAT
AAAAAAAATTGGACCCTCACACTG	GGATTTATCCGGTTAG
AAAAAAAAGTCCGGAACCTGGTGA	GGCAAATCATGGCCTG
AAAAAAAACGCTAATTGAGGGACC	GGCAATCGTCCTTCTC
AAAAAAAAAGGTTCCTGAGGGACC	GGCAATCGTTAAGTGT
AAAAAAAAACCCGCACTCAGCAAA	GGCAGGATCTTGCATT
AAAAAAAAGTTAGGCGACTAATTC	GGCATGGAGCAGGTTT
AAAAAAAATGGTTAGGACTAATTC	GGCATGGAGGAACCGG
AAAAAAAACGCATTATGCTCAGTA	GGCATTAGTGGATTAT
AAAAAAAATGTGCACCTACTAACC	GGCATTGTCGCTAAAC
AAAAAAAAAGTAAGTCTAGCACGA	GGCCAACTCAATACGC
AAAAAAAACAAGCTCCTAGCACGA	GGCCAACTCCATAAGC
AAAAAAAATCAAATCCTAGCACGA	GGCCAACTCCGGAACC
AAAAAAAACTTAATGCTAGCACGA	GGCCAACTCTTAGGGT
AAAAAAAAGTTTGTCGATATTCGT	GGCCATCAGAAAGCAT
AAAAAAAATTATCACGATATTCGT	GGCCATCAGCATTAGC
AAAAAAAAAGCAATACTTCCAGGT	GGCCTAATCAGCAAGA
AAAAAAAACGGAAACTGTTGACCA	GGCCTCTGTTAACGAT
AAAAAAAAAAACCATGAGCTTAAA	GGCCTTAAGATAAAGC
AAAAAAAAGTAGCTGGAGCTTAAA	GGCCTTAAGGGTTAGA
AAAAAAAATGACAACGAGCTTAAA	GGCCTTAAGTACCGCA
AAAAAAAATCCACCTTGCAAGCGA	GGCCTTCGTAAGGTTT
AAAAAAAAGCTGTCATGCAAGCGA	GGCCTTCGTCAAGTAT
AAAAAAAATCGATCATGCAAGCGA	GGCCTTCGTCCACAAA
AAAAAAAAGCGGTCAACATAGACC	GGCGATACAACCGCCA
AAAAAAAACTGCACCACATAGACC	GGCGATACAGGCATGA
AAAAAAAAGCGGTACACATAGACC	GGCGATACATAGTCAT
AAAAAAAAGAATCACACATAGACC	GGCGATACATTGCGTA
AAAAAAAAGGTCATGGAGCAAGAA	GGCGGTAAGGACTAAG
AAAAAAAAACCAGGTGAGCAAGAA	GGCGGTAAGTTGTCAA
AAAAAAAAGGCTTTACTTGACTTA	GGCGGTTTCCTCAGCT
AAAAAAAAGACCAAGCTATGATGA	GGCGTTATCCATTACT
AAAAAAAAGGTTCATCTATGATGA	GGCGTTATCTTAATGG
AAAAAAAAAGTCACAACGTTGTAG	GGCTAGACAAATATCC
AAAAAAAAGCCATAAACGTTGTAG	GGCTAGACACCTGTAA
AAAAAAAAACCGGACACGTTGTAG	GGCTAGACATTAGGCC
AAAAAAAAGTTTAACTGCTTGTTT	GGCTAGTGTGATGAGG
AAAAAAAATGCTCTCTGCTTGTTT	GGCTAGTGTTGCTTCG
AAAAAAAATGTTGGCCTAACCGGA	GGCTATGTCACTAGGT
AAAAAAAATAGCTATCTAACCGGA	GGCTATGTCCGGCTAA
AAAAAAAAGCTATACCTAACCGGA	GGCTATGTCCTGTTCA
AAAAAAAATTCGTAACTAACCGGA	GGCTATGTCTATGACA
AAAAAAAATCATGGAGAAACCGCA	GGCTATTAGACCATAC
AAAAAAAATCCCTTTGAAACCGCA	GGCTATTAGGCATTAC
AAAAAAAATTTAGCTGAAACCGCA	GGCTATTAGTAATCCA
AAAAAAAAACACCTTGAGGAACGG	GGCTGAGAGTTGTCTT
AAAAAAAAACGTAAACTGTTGCAT	GGCTGGTTCGGTCAAT
AAAAAAAATTTAGTGCTGTTGCAT	GGCTGGTTCTAAGTCA
AAAAAAAAGTTAAAGCTGTTGCAT	GGCTGGTTCTCGCCTG
AAAAAAAACCAACAAGAGTAACTA	GGCTGTCAGCCACATG
AAAAAAAATGCAGGATGTCATCAG	GGCTTAAGTTTCCTCC
AAAAAAAAGAGTTGCGACCGGTGA	GGCTTCAAGATGGAGC
AAAAAAAAGCACTAGGACCGGTGA	GGCTTCAAGCTAATTG
AAAAAAAAGCCGATAGACCGGTGA	GGCTTCAAGTAACGAG
AAAAAAAATAGCCACCTCAGCTAC	GGGAATATCGATTTGA
AAAAAAAAGGAGAAACTCAGCTAC	GGGAATATCGGTTTCC
AAAAAAAACTTAGCGCTCAGCTAC	GGGAATATCTCCTCAA
AAAAAAAACGCAAGGCTCAGCTAC	GGGAATATCTGCAACG
AAAAAAAATCAGGTAGAGCTTATC	GGGATTAAGTTAGTTG
AAAAAAAATTTCCGGGACCTTGTG	GGGCAATAGCCAGTAT
AAAAAAAATGGGCGTGACCTTGTG	GGGCAATAGGCGAAAC
AAAAAAAAAATTGTGGACCTTGTG	GGGCAATAGGTCCAAT
AAAAAAAAAGGGTGGGAAATTACG	GGGCATGAGAATGACG
AAAAAAAATCCTAAGTGGCAATAG	GGGCATTGTTAACGGC
AAAAAAAATCCATCCTGTCCTGAA	GGGCCTAGTATTCGCT
AAAAAAAACACAGGATGTCCTGAA	GGGCCTAGTTATGTGG
AAAAAAAATAGGTGACTGTACCTA	GGGCGAATCTTGAGCG
AAAAAAAACAAGGTCACTAAGGTT	GGGCTAACACTTACAG
AAAAAAAAGCGGATACTACTCACA	GGGTCACTCCTTGAGG
AAAAAAAACAGGCCTTGGCTTAGC	GGGTGAAGTCATGAGC
AAAAAAAAGTTACCGTGTGCAAGG	GGGTGTTGTCCTAATC
AAAAAAAACCTGCTCCTTCAATAC	GGGTTATTCTTGACCC
AAAAAAAAGAACCGCACCCGCTCA	GGGTTTCCAGGAACAT
AAAAAAAAGTCGATTCTAGGATGC	GGGTTTGTCATTTGTC
AAAAAAAATTCCTTGCTAGGATGC	GGGTTTGTCCCGTTTA
AAAAAAAATACGCCACTAGGATGC	GGGTTTGTCCCTGGAA
AAAAAAAAGCAGTTAACTCACAAA	GGTAAACCAACTAGAA
AAAAAAAATAAGGTTACTCACAAA	GGTAAACCACGAATCC
AAAAAAAACAGATAATGTTGAGCT	GGTAACCGTAGGTTAT
AAAAAAAAGGGTAGCTGTTGAGCT	GGTAACCGTCCTAAGA
AAAAAAAAGCCAGGATGTTGAGCT	GGTAACCGTTATCGAG
AAAAAAAAAGTTGTCCTCGCAATC	GGTAACTTCAATTACG
AAAAAAAAGTAATGACTCGCAATC	GGTAACTTCGGTTTGG
AAAAAAAAAAATCCTTGAAGCCCT	GGTAAGGGTGTTTCAC
AAAAAAAAGATGACATGGCTAAAG	GGTAATTGTAATAACC
AAAAAAAACACATACTGGCTAAAG	GGTAATTGTGCAACTA
AAAAAAAAACCATTATGGCTAAAG	GGTAATTGTTTATCTG
AAAAAAAAGCTGTGAGAGGCTTGA	GGTACAAAGGCTGGCT
AAAAAAAATCATCATGAGGCTTGA	GGTACAAAGTCATTGA
AAAAAAAAGGATTGATGTTTGTGG	GGTACCGGTTTACTTG
AAAAAAAAAGAGGGATGATCCTTC	GGTACTAGTAAGCACC
AAAAAAAACTCAGGCTGATCCTTC	GGTACTAGTAATCCCT
AAAAAAAATTGCGCGTGATCCTTC	GGTACTAGTCAATACG
AAAAAAAACGCCAACTGATCCTTC	GGTACTAGTCATTACC
AAAAAAAAAAACGGTTGATCCTTC	GGTACTAGTGGTTAGC
AAAAAAAATGCAACAGATCACAGA	GGTACTTAGAGGCTAA
AAAAAAAAGATTCCTGATCACAGA	GGTACTTAGGACCTCA
AAAAAAAATATCTGTGATCACAGA	GGTACTTAGTACTGGT
AAAAAAAAAGGTGCACTGTGAGCA	GGTATGTTCAGGTTTA
AAAAAAAATCGCAACCTGTGAGCA	GGTATGTTCGTAATCA
AAAAAAAATAGGTAGCTGTGAGCA	GGTATGTTCTAATCTC
AAAAAAAATATTAGCCTGTGAGCA	GGTATGTTCTATCGCC
AAAAAAAAGATGACATGATTGACT	GGTATTGGTAATAACC
AAAAAAAACAAGGGTTGATTGACT	GGTATTGGTTTGTGGA
AAAAAAAATCCGTTAACGCTAACA	GGTATTTCAATAAGCA
AAAAAAAACTCTATGACGCTAACA	GGTATTTCACACCAAC
AAAAAAAAGCGGTTGACTCCCTGG	GGTCAAGCAAGGAATC
AAAAAAAATGCCTTTCTTGCTCAG	GGTCAATTCGACAAAG
AAAAAAAAACTCATGCTTGCTCAG	GGTCAATTCGTTTCTG
AAAAAAAAGGATTGCGATTAGCTT	GGTCAGGAGGTGTTAC
AAAAAAAACCAACAAGAGCGGTTA	GGTCATTAGCCACATG
AAAAAAAACACCAAAGAGCGGTTA	GGTCATTAGTCAATTG
AAAAAAAAAACTAACGAGCGGTTA	GGTCATTAGTCACGAT
AAAAAAAAAAATCGCACAAGCGCC	GGTCCATCAGGAAGCC
AAAAAAAAAACCTAAGATTAGCGA	GGTCCGTAGAATCTCA
AAAAAAAAGCTAAATGATTAGCGA	GGTCCGTAGATAACCC
AAAAAAAAAAGTTTGGATTAGCGA	GGTCCGTAGCGGATTT
AAAAAAAAGAGAAACGATCGCTCA	GGTCTTGAGGAAACTG
AAAAAAAACTCTAGCGATCGCTCA	GGTCTTGAGGGCTAAA
AAAAAAAAAAATACGCTCACAAAG	GGTGAGGTCTAACTGA
AAAAAAAACCCTAAGCTCACAAAG	GGTGAGGTCTCAATTC
AAAAAAAAGTTACCTGATAACGGT	GGTGAGTAGGATTGCT
AAAAAAAAGGGTTTGGATAACGGT	GGTGAGTAGTGTTGTA
AAAAAAAATCAAATCCTCCCAAAC	GGTGATTTCCGGAACC
AAAAAAAAGAATGCATGTCCAAAC	GGTGCTGGTTAGCATG
AAAAAAAATGGGAGGACAGCTAAC	GGTGCTTCATAACGGG
AAAAAAAATAAACCAACAGCTAAC	GGTGCTTCATTGCAGC
AAAAAAAAGGCTTAGGACTTCGAC	GGTGTCCAGACACTTA
AAAAAAAACGGGATTACCGTTACT	GGTGTGACACATAGCC
AAAAAAAATGGATTAACCGTTACT	GGTGTGACACCTGGTG
AAAAAAAACGTCCCTCTTTGGTTA	GGTGTTGTCTTACTCG
AAAAAAAAGCTGTCATGACATTGT	GGTTAATGTCAAGTAT
AAAAAAAATGTAAGTACGGATCGC	GGTTACCCATTATGGT
AAAAAAAAGCCTATTGAGCGAACT	GGTTACTAGCGCAATT
AAAAAAAAATGACAGTGGACGAAT	GGTTATGGTTTATGGG
AAAAAAAACGTTATGTGGCAAATG	GGTTCCCGTAATCGTG
AAAAAAAATCCTCCATGCAAACCT	GGTTCTTGTTGTCCAT
AAAAAAAACGTTAGGACCAATATG	GGTTGAGCAAGCTTAT
AAAAAAAACAGGTTCCTTCACCAG	GGTTGCATCACTTTAC
AAAAAAAAAGGTGCACTTCACCAG	GGTTGCATCAGGTTTA
AAAAAAAAGGCATGACTTCACCAG	GGTTGCATCCAGGTTG
AAAAAAAATGAGTGACTTCACCAG	GGTTGCATCCTGGCTT
AAAAAAAAGTAGCAGCTTCACCAG	GGTTGCATCTTGTTCG
AAAAAAAACTTCGTAACTGACTAA	GGTTGCTCACAACAAA
AAAAAAAAAGAAATGACTGACTAA	GGTTGCTCACTTAGGC
AAAAAAAACGCTAAGACTGACTAA	GGTTGCTCAGAATGAC
AAAAAAAAACTGCAAACTGACTAA	GGTTGCTCAGTTATGT
AAAAAAAAGTGCGAGTGTTCCATT	GGTTGGTGTATTGAGT
AAAAAAAACAATCCATGTTCCATT	GGTTGGTGTCCAAATG
AAAAAAAAACTCAATTGTTCCATT	GGTTGGTGTGGTGAGA
AAAAAAAAGGCTAAGCTAAATACG	GGTTTCCTCATCAGTA
AAAAAAAAAGAGCAAGAACAGATT	GGTTTGTAGGAAGTAT
AAAAAAAAAACGGTTACATAACGC	GTAAAGCCAATGCCTA
AAAAAAAATGACAATACATAACGC	GTAAAGCCACCTCACC
AAAAAAAACTAGTAAACATAACGC	GTAAAGCCAGTAAAGC
AAAAAAAACCCTGTGACATAACGC	GTAAAGCCATGAGTTT
AAAAAAAAGTAACACACAGCCATA	GTAAGCGCAAACAACA
AAAAAAAAAGTCGAGCTAGCCACC	GTAAGCTTCATGCTAA
AAAAAAAAACTAAAGCTAGCCACC	GTAAGCTTCATTTGCT
AAAAAAAACTACTAACTAGCCACC	GTAAGCTTCTGTTCAT
AAAAAAAACAAACCGACCGGTTGA	GTAAGGTCACACAATT
AAAAAAAACTCTATGACCGGTTGA	GTAAGGTCACACCAAC
AAAAAAAATCATCACACCGGTTGA	GTAAGGTCATAGCTTG
AAAAAAAAATCCGGGACCGGTTGA	GTAAGGTCATCATGTG
AAAAAAAAGTAAGCTACCAAAGCC	GTAATAGCAACCTAAT
AAAAAAAAGCAGTTAACCAAAGCC	GTAATAGCAACTAGAA
AAAAAAAAAACGCTAACCAAAGCC	GTAATAGCAAGTAAGC
AAAAAAAACGAGGTTACCAAAGCC	GTAATAGCACAACCTA
AAAAAAAAGACAATGTGGACCCTA	GTACAATGTTAACACG
AAAAAAAAATTGGGATGGACCCTA	GTACAATGTTGCGGAT
AAAAAAAAAGGCGCATGAAGGACT	GTACCGGGTATTTGGG
AAAAAAAACTGCTAATGAAGGACT	GTACCGGGTTACAAAC
AAAAAAAAAGCCTGTTGAAGGACT	GTACCGGGTTAGTACG
AAAAAAAAAGATGCATGCTCTCTG	GTACCTTGTTCGGGAT
AAAAAAAAGGTTTATTGCTTCATT	GTACGTAGTAGGTTGC
AAAAAAAAGCAGTAATGCTTCATT	GTACGTAGTATTGGAT
AAAAAAAACACATACTGCTTCATT	GTACGTAGTGCAACTA
AAAAAAAAGTTCCTTTGCTTCATT	GTACGTAGTGGTTATG
AAAAAAAACGATTCATGCTTCATT	GTACGTAGTTACCTGT
AAAAAAAATGCTATGTGCTTCATT	GTACGTAGTTTGGGTA
AAAAAAAAATGATGACTAAGCCTT	GTACTAATCAGGTCCA
AAAAAAAAGGTTGTTCTAAGCCTT	GTACTAATCCAACTGG
AAAAAAAAAAGCCCTTGCGCAGTC	GTACTAGGTAGTTGGC
AAAAAAAAATACAGGTGCGCAGTC	GTACTAGGTCAATGTG
AAAAAAAAATGACAGTGCGCAGTC	GTACTAGGTTTATGGG
AAAAAAAAACAGAATCTACATAAG	GTACTGGTCGATATTG
AAAAAAAATTACTCCCTACATAAG	GTACTGGTCTAGCTTT
AAAAAAAAATTAGCCCTACATAAG	GTACTGGTCTCAATAG
AAAAAAAACAATTGGGAGGCGGAA	GTACTTAAGCATGCAT
AAAAAAAACTGGCAGGAGGCGGAA	GTACTTAAGCCTCTCG
AAAAAAAAATTCCTGGAGGCGGAA	GTACTTAAGGTATTGC
AAAAAAAACATTTGTGAGGCGGAA	GTACTTAAGTCACCAG
AAAAAAAATTATTCCTGAACCTAT	GTACTTCGTGCTTTAC
AAAAAAAATAAGCCTTGAACCTAT	GTACTTCGTTCATTTG
AAAAAAAAGAATATGCTGATTCTG	GTAGCCATCGGGCCAT
AAAAAAAATTAAGTCCTGATTCTG	GTAGCCATCGGTTACG
AAAAAAAATTCGCGCACCTTACGT	GTAGGATCAAACCTAT
AAAAAAAACAGTGTGACCTTACGT	GTAGGATCACGAACAG
AAAAAAAAATGCTTTACCTTACGT	GTAGGATCATCACTTC
AAAAAAAAATAATGCGAGGCACTA	GTAGGCGAGCAAGACA
AAAAAAAAGCCAAATACGATAACC	GTAGGTGCACTTCATC
AAAAAAAACAACAAGCTTAGCGGG	GTAGTTATCCCTTGCG
AAAAAAAACGGCTATCTTAGCGGG	GTAGTTATCCTCCATA
AAAAAAAAGCGTGTCCTTAGCGGG	GTAGTTATCGTGCCTT
AAAAAAAAGGTGAGAACGAATCCA	GTAGTTTCAACGTGCT
AAAAAAAAGCAGTTAACGAATCCA	GTAGTTTCAACTAGAA
AAAAAAAACCTAAGGACGCCCAGA	GTATCGCCATTGTCCT
AAAAAAAACTCGCACACCCAGCAA	GTATGTTCAAGTGTCC
AAAAAAAACGAGGTTACCCAGCAA	GTATGTTCACAACCTA
AAAAAAAATGACAATACCCAGCAA	GTATGTTCACCTCACC
AAAAAAAACTGAGTGACCCAGCAA	GTATGTTCATCCATCT
AAAAAAAACGCTAAAGAGCTAACG	GTATTCAAGACAACGA
AAAAAAAAGGATCCAGAGCTAACG	GTATTCAAGTGAACGA
AAAAAAAACCAATATCTGCTATTG	GTATTGATCCTAATGA
AAAAAAAAGATTCAAGAAGTGAAG	GTATTGCAGGCAAGTA
AAAAAAAAGTCTTGACTGTGATTC	GTCAAACTCATGACCG
AAAAAAAATTGCTCTCTTTACTAG	GTCAGGCTCACATTGA
AAAAAAAAAGGTGCACTTTACTAG	GTCAGGCTCAGGTTTA
AAAAAAAATGTGTTACTGTTACAC	GTCATCCTCACAGCCA
AAAAAAAACTACTAGTGTTCCCAC	GTCATGAGTCCAAGAC
AAAAAAAACACCATATGTTCCCAC	GTCATGAGTTTATTCG
AAAAAAAAGCTATACCTCAGTTAT	GTCCAAGTCCTGTTCA
AAAAAAAAGGGATATTGCGAAACG	GTCCATTGTGGGTACT
AAAAAAAAGTTGACCTGCGAAACG	GTCCATTGTTGCACGG
AAAAAAAACTGGCTTGAGCATAGC	GTCCGTAAGATTGAGG
AAAAAAAAACCTCGCGAGCATAGC	GTCCGTAAGCACTAAC
AAAAAAAACAGCAAGTGGAGACTA	GTCCTCAGTTCGCTTG
AAAAAAAATTGCATGTGGAGACTA	GTCCTCAGTTTGGTTC
AAAAAAAAACTGACAACCGCCCAT	GTCCTCCCACAGGAAT
AAAAAAAATTGTTGCACCGCCCAT	GTCCTCCCAGAGGGAG
AAAAAAAATCAGTAAACCGCCCAT	GTCCTCCCAGCAAGAT
AAAAAAAACCCTCCTGACAGGTAT	GTCGAGGAGACACCGC
AAAAAAAACTCAAAGGACAGGTAT	GTCGAGGAGGAAGCTA
AAAAAAAAGTTTGTCGAATGACCG	GTCTAACAGAAAGCAT
AAAAAAAAGATAATCGAATGACCG	GTCTAACAGTCACTAA
AAAAAAAAACCTTGCACTGAGTGC	GTCTAATCAAGCTTTG
AAAAAAAATGTAATGACTGAGTGC	GTCTAATCATTAAAGG
AAAAAAAAACCCGGAACGTGCCTT	GTCTAGCCAACCCTAA
AAAAAAAATAATTGGACGTGCCTT	GTCTAGCCACAATGCC
AAAAAAAACCATTACACGTGCCTT	GTCTAGCCATTGTGAT
AAAAAAAAAGGGTATTGCGTAACT	GTCTATCGTGTGCACG
AAAAAAAAGCAAGTATGCGTAACT	GTCTATCGTGTTGCTT
AAAAAAAAACCCGGAACCGGTAAC	GTCTATGCAACCCTAA
AAAAAAAAAGCCCTTACCGGTAAC	GTCTATGCATTCAGCA
AAAAAAAAGAAGTCATGCCAGCAC	GTCTTTAGTCAAACTG
AAAAAAAAAGTAACGTGCCAGCAC	GTCTTTAGTCTAGCTT
AAAAAAAATTACAACCTAAGACTA	GTCTTTGTCCTGGTCT
AAAAAAAACGTTTGGCTAAGACTA	GTCTTTGTCCTTAAGA
AAAAAAAAAACGAATCTAAGACTA	GTCTTTGTCGCAACAT
AAAAAAAATAGGTGACTCCTCATT	GTGAATCTCTTGAGCG
AAAAAAAAGTTTAACTGATCAGGA	GTGATCAGTGATGAGG
AAAAAAAATAGACAATGATCAGGA	GTGATCAGTTAAATGC
AAAAAAAAATTGTCATGATCAGGA	GTGATCAGTTACTAGG
AAAAAAAATATCTGTGATAACCGA	GTGATGAAGTACTGGT
AAAAAAAAGGTAGCTGATAACCGA	GTGATGAAGTCTTGAA
AAAAAAAACATAGGTGAATATCAG	GTGCATTAGGCATGTT
AAAAAAAATTTGCGCGAATATCAG	GTGCATTAGTCTCACC
AAAAAAAAACCTCATGAATATCAG	GTGCATTAGTTAGCCG
AAAAAAAAGAAATACCTTAGTCAT	GTGCCTTTCTGTGAGT
AAAAAAAAATGCATAGAGGAACAA	GTGCTCAAGGACAACA
AAAAAAAACCGGTAAACCCGCCTA	GTGCTTACAAGCCACT
AAAAAAAATCCGGAAACCCGCCTA	GTGCTTACACATAACT
AAAAAAAACCACTTAACCCGCCTA	GTGCTTACACATTGCA
AAAAAAAAACCTTTAACCCGCCTA	GTGCTTACAGATAGAC
AAAAAAAACCACTATACCCGCCTA	GTGCTTACAGTCTAGC
AAAAAAAATGCTACTACCCGCCTA	GTGCTTACATGCTCCC
AAAAAAAAAGTCAGTACGAGCAAG	GTGGACACATGAAATG
AAAAAAAATTACCCAACGAGCAAG	GTGGACACATTATGAC
AAAAAAAACTATTGCACAGGAACG	GTGGCTTCAATATGGA
AAAAAAAAGACTTGCTGATTACGT	GTGGTTAGTTTACCGT
AAAAAAAATTGTTGCACGTAGCGC	GTGTGAGCAGAGGGAG
AAAAAAAAAAATCCTTGGCCATTG	GTGTGCGGTGTTTCAC
AAAAAAAAATCCATATGGCCATTG	GTGTGCGGTTGAATCG
AAAAAAAAGCGCATTTGGCCATTG	GTGTGCGGTTGTTGTC
AAAAAAAAGTACTTCGAACCAGCA	GTGTTACAGAGGATAT
AAAAAAAATGGTGCGGAACCAGCA	GTGTTACAGCTGGACC
AAAAAAAATACGGGCGAACCAGCA	GTGTTACAGTATCGCG
AAAAAAAAGAAAGCCCTTAATTCG	GTGTTCCTCAGGATGA
AAAAAAAAGTTGCTGTGCCGCAAC	GTTAAACGTATACTGG
AAAAAAAAGCTTCATGACTGAGCG	GTTAACCAGTTATTCC
AAAAAAAACTGAAGGTGAAGGATC	GTTAACGGTCCTAACT
AAAAAAAACTGGATCCTACTAGCT	GTTAAGCTCCTCATCA
AAAAAAAACAGGTCCTGCGTGATT	GTTAAGTGTGAGGTAG
AAAAAAAATTGAGCTTGCGTGATT	GTTAAGTGTGAGGTGA
AAAAAAAAAAATCCTTGCGTGATT	GTTAAGTGTGTTTCAC
AAAAAAAAGTAGTAACTGAGCAAC	GTTAATGTCCTACCTA
AAAAAAAACTCAGGCTGCCTCAAA	GTTACAGGTAATCCCT
AAAAAAAAGAGAAGGTGTCACGAT	GTTACCTGTACCCACC
AAAAAAAAGCAAGTATGTCACGAT	GTTACCTGTGTTGCTT
AAAAAAAAAGTCACCTGTCACGAT	GTTACCTGTTAGGTGC
AAAAAAAACATAAGTACATCAAGC	GTTACGCCAAATTCGT
AAAAAAAAAGCGAGGGACACAAAC	GTTACTAAGGTAAGGC
AAAAAAAAGGCTCATTGAGTTAGG	GTTACTCGTCACCAAA
AAAAAAAAGATGTAACTCATGAAG	GTTAGACTCTCCATGC
AAAAAAAATGTTAGCTGGTTTACA	GTTAGGCGTTCACCCA
AAAAAAAATAGCAAGCTAGTTGGG	GTTCACCTCATTAGGC
AAAAAAAACAATGAGCTAGTTGGG	GTTCACCTCCGCTAGA
AAAAAAAATGATTTGCTAGTTGGG	GTTCACCTCGTTAAGC
AAAAAAAACTACTAACTAGTTGGG	GTTCACCTCTGTTCAT
AAAAAAAAAATCCACCTAACCTGT	GTTCATTTCCCGAAGC
AAAAAAAAGATTCACCTAACCTGT	GTTCATTTCCTCATGC
AAAAAAAAGCCTAATCTAACCTGT	GTTCATTTCGTTAGTA
AAAAAAAACATCATGTGTGCAGCC	GTTCCCAGTCAGGCCA
AAAAAAAAGCTCCCTTGTGCAGCC	GTTCCCAGTCTCACTG
AAAAAAAATTAGTGCTGTGCAGCC	GTTCCCAGTTGTCATC
AAAAAAAACGGAAACTGGCTATAT	GTTCCTGGTTAACGAT
AAAAAAAAGCCACTTACTCACGGA	GTTCCTTCACCCTCAC
AAAAAAAAACCGAATACTCACGGA	GTTCCTTCAGGACCAA
AAAAAAAACTATAACCTAATCACC	GTTCGCTTCATTGCAA
AAAAAAAAAGCAAGCCTCCATCAG	GTTCTCATCACCATTT
AAAAAAAAAAATACGCTCCATCAG	GTTCTCATCTAACTGA
AAAAAAAATCGCTAATGCACAGCC	GTTCTTAGTTTAACCC
AAAAAAAATCAGTTTGACTAGTAG	GTTGCATAGTTAGGCT
AAAAAAAATGCAGGATGGTGAAGT	GTTGCCCGTTTCCTCC
AAAAAAAAGTTAGGCGAGGGACTT	GTTGCTGAGCAGGTTT
AAAAAAAACTAGTCTACAAACTCG	GTTGGAGCAGTTTACG
AAAAAAAACTTAAGAACAAACTCG	GTTGGAGCATAATTGC
AAAAAAAATAGCTGAGAGTGTTTC	GTTGGCCAGTCCTTCA
AAAAAAAACTAGTAAACAAACGCT	GTTGTTGCAGTAAAGC
AAAAAAAACGGTTAGACAAACGCT	GTTGTTGCATAGCGAG
AAAAAAAACCAGCAAACCTGGTTT	GTTTAACCACCAGGTT
AAAAAAAAGCTCGTTACCTGGTTT	GTTTAACCACCTATAG
AAAAAAAACGAATATACCTGGTTT	GTTTAACCACCTGCCT
AAAAAAAATGATCCTACCTGGTTT	GTTTAACCACTGGCTG
AAAAAAAATAGACAATGTTGTTGG	GTTTACCGTTAAATGC
AAAAAAAATGGCTATTGTTGTTGG	GTTTACCGTTCACTGT
AAAAAAAACCTTCAGGACTTAGCC	GTTTAGCAGTTATCCT
AAAAAAAACCATAAGGACTTAGCC	GTTTAGCAGTTGGCCA
AAAAAAAAGAAGCACCTTGAGGAT	GTTTATCTCAAACCTA
AAAAAAAATTCCTTGCTTGAGGAT	GTTTATCTCCCGTTTA
AAAAAAAATAGGTTTCTTGAGGAT	GTTTATCTCGCTCACT
AAAAAAAACGTCCCTCTTGAGGAT	GTTTATCTCTTACTCG
AAAAAAAAGTCTTTAACTTACCGT	GTTTCCTCACAATGTT
AAAAAAAACAGTGTGACTTACCGT	GTTTCCTCACGAACAG
AAAAAAAAAAATCGCACTTACCGT	GTTTCCTCAGGAAGCC
AAAAAAAAGGGTTAATGAATCGCC	GTTTCTAGTTAGGTTG
AAAAAAAAGCAATGCGAAGCTAAT	GTTTGTAAGAGGAAGG
AAAAAAAACCTAATTGAAGCTAAT	GTTTGTAAGCCGCAGT
AAAAAAAAAATAGCTGAAGCTAAT	GTTTGTAAGCGATACT
AAAAAAAAGGAGGGTGAAGCTAAT	GTTTGTAAGGGCCATC
AAAAAAAACTTTAGGTGGTTCCTT	GTTTGTCGTAAGCTTG
AAAAAAAAGTCCTGATGGTTCCTT	GTTTGTCGTCACCTAT
AAAAAAAACAGCTACCTCTTGAAT	GTTTGTTTCCCGTTGT
AAAAAAAATAACCTACTTAGTGTT	TAAAGCCTCCAGCACA
AAAAAAAACTATATGCTTAGTGTT	TAAAGCCTCCCTGATC
AAAAAAAATTCGCGACTTAGTGTT	TAAAGCCTCTGTAATG
AAAAAAAAAGTCCTCACGCAACAT	TAACAAGCAAGTGAAC
AAAAAAAAAACCTTTACGCAACAT	TAACAAGCATAGACCC
AAAAAAAACACCATTACGCAACAT	TAACAAGCATGCATAT
AAAAAAAAGATCAGTACGCAACAT	TAACAAGCATTAGCGC
AAAAAAAAGGCCTCACTAACCGTT	TAACCGGTCATGCTTT
AAAAAAAAATACAGGTGTGTGGTT	TAAGCCAGTCAATGTG
AAAAAAAAAACTGATGAATTAAGC	TAAGCCTAGCATCCAG
AAAAAAAACAGGTTCCTGCAGGTA	TAAGCTATCACTTTAC
AAAAAAAATCCATAACTGCAGGTA	TAAGCTATCAGCACGC
AAAAAAAAGACAAGCCTGCAGGTA	TAAGCTATCTCAATGA
AAAAAAAAGTAGCAGCTGCAGGTA	TAAGCTATCTTGTTCG
AAAAAAAAGGAACATTGGTTCTGG	TAAGCTGGTCCTAGTT
AAAAAAAAAGACTCAACGTTTCGC	TAAGGACCAATGCCCG
AAAAAAAACAGGACTACGTTTCGC	TAAGGACCAATTGAAG
AAAAAAAAACGCAATACGTTTCGC	TAAGGACCACAACAGG
AAAAAAAAAGCACTAACGTTTCGC	TAAGGACCACCGTTCC
AAAAAAAAACACCAAACGTTTCGC	TAAGGACCAGGTTATT
AAAAAAAAATGCTTTACGTTTCGC	TAAGGACCATCACTTC
AAAAAAAACCGGTTACTAACCTAC	TAAGGCTTCCGTTAAA
AAAAAAAAAAATGGAACGGTTAAC	TAAGTAGCAACCCTCC
AAAAAAAACCGTTGCACGGTTAAC	TAAGTAGCACGGTACT
AAAAAAAATGCACTTACGGTTAAC	TAAGTAGCAGAGGCTA
AAAAAAAACTACCGCACGGTTAAC	TAAGTAGCATTTGCTC
AAAAAAAATTCAGTACTTAAGCCC	TAAGTGCTCCCTGGTT
AAAAAAAATCGCTATACTATGTGA	TAATCACCAATGAAGC
AAAAAAAACATGGTGACCATTAAG	TAATCCGCATACCCGG
AAAAAAAAAACCTTTACCATTAAG	TAATCCGCATAGACCC
AAAAAAAAAGGCCCAACCATTAAG	TAATCCGCATGCAACC
AAAAAAAAGTGCAAGCTTGTCCAG	TAATGCATCCGCCTAT
AAAAAAAATCAATTGCTTGTCCAG	TAATGCATCTCCATAT
AAAAAAAACCACTTAACGGTACGC	TAATGGACACATTGCA
AAAAAAAAAAGCATGTGATCACAT	TAATGGTGTTTGGCGG
AAAAAAAAGGCCGATACCTTACCA	TAATTGCCAATTAACC
AAAAAAAAAGCCCTTACCTTACCA	TAATTGCCATTCAGCA
AAAAAAAATTAGGAGCTGATGGAC	TACAACATCACGTTAA
AAAAAAAAGTGGACACTGATGGAC	TACAACATCACTTCAT
AAAAAAAAAACCAGGCTGATGGAC	TACAACATCCGCCAAA
AAAAAAAATCCTCTACTGATGGAC	TACAACATCGCACACA
AAAAAAAAAAATGACCTGGAAGCT	TACAAGCTCGCAGGCT
AAAAAAAAGCTCAATCTGGAAGCT	TACAAGCTCTTAGTCT
AAAAAAAAAGCAATACTATTACGC	TACAATGTCAGCAAGA
AAAAAAAATCTTGCTCTATTACGC	TACAATGTCAGTTCCC
AAAAAAAAACAGCACGAGGTTAGC	TACAGCTAGCATGACT
AAAAAAAACTTTAACGAGGTTAGC	TACAGCTAGCTATATG
AAAAAAAACGCAATCCTGAGGAGG	TACAGGTTCGAAGTGA
AAAAAAAAACAATTGGAAGCTTAA	TACATCAAGCACAGGG
AAAAAAAAAATCCACCTAAAGCGC	TACCAAATCCCGAAGC
AAAAAAAATTACAACCTAAAGCGC	TACCAAATCCTGGTCT
AAAAAAAATTCCTTGCTGATGAAT	TACCAGGTCCCGTTTA
AAAAAAAAGCAATTGACCACAATA	TACCCGGCATTGACAT
AAAAAAAATAGCTCATGAGGAACT	TACCGAAGTAGCCTCC
AAAAAAAAAGGCGGTTGAGGAACT	TACCGAAGTGATTACG
AAAAAAAACGGACAATGAGGAACT	TACCGAAGTTAAGGTT
AAAAAAAATATCAGGGAACCTAGG	TACCGCAAGTTACCGG
AAAAAAAAATGCTATTGCACACCG	TACCGTTGTTAGTTGG
AAAAAAAATTAGTGCTGCACACCG	TACCGTTGTTGTCATC
AAAAAAAATGCTAATCTTGACTAT	TACCTCATCGAGCAAA
AAAAAAAATCGCAACCTTGACTAT	TACCTCATCGTAATCA
AAAAAAAATATTAGCCTTGACTAT	TACCTCATCTATCGCC
AAAAAAAACAGTTTACTGTCCATA	TACCTGCTCCGCACAA
AAAAAAAAGGCAATATGCTAGCCG	TACCTTAGTAGGATTT
AAAAAAAACTTCTATTGCTAGCCG	TACCTTAGTGAGCACT
AAAAAAAATTTAGGCTGCTAGCCG	TACCTTAGTGGAGCAA
AAAAAAAATAGACCAGAAATCGCG	TACCTTTAGCCTTAAA
AAAAAAAATGGTTAGGAAATCGCG	TACCTTTAGGAACCGG
AAAAAAAAGCTCAAGGAAATCGCG	TACCTTTAGGCTACTG
AAAAAAAAATTGTTCACATTACGG	TACGCACCAAGGTATA
AAAAAAAAGTGGCCAACATTACGG	TACGCACCAAGTTATC
AAAAAAAAGGTACTAACATTACGG	TACGCACCAGTCTAAT
AAAAAAAATAGTAACACATTACGG	TACGCACCAGTTTGTG
AAAAAAAAAGCTATTTGCGCATCG	TACGCTTGTGCTCACC
AAAAAAAAGGCATGACTAGGTATA	TACGGATTCCAGGTTG
AAAAAAAAGAGGTGGGAAGCGAGG	TACGGTTAGAGGGACT
AAAAAAAACTGCTGTGAAGCGAGG	TACGGTTAGGGATGAC
AAAAAAAAGACCTAGGAAGCGAGG	TACGGTTAGTAAGTCC
AAAAAAAATCGTTATGAAGCGAGG	TACGGTTAGTTTGGGT
AAAAAAAAATCGCGCCTTCAACCG	TACGTAATCACCTGCT
AAAAAAAAGATATAGCTTCAACCG	TACGTAATCATTAGCA
AAAAAAAAGGGAGGACTTCAACCG	TACGTAATCTCACATT
AAAAAAAAATATTGGGACTAAGGT	TACGTACAGCTTTGGG
AAAAAAAAAGCTAGCGACTAAGGT	TACGTACAGGCGCTAC
AAAAAAAACGATTGAGACTAAGGT	TACGTACAGGTGAAAT
AAAAAAAATTACCCGGACTAAGGT	TACGTACAGTGAGAGC
AAAAAAAAAGACTTAGACTAAGGT	TACGTACAGTGCACGC
AAAAAAAATCGTTATGACTAAGGT	TACGTACAGTTTGGGT
AAAAAAAAGGCTGATGATTAGCAG	TACGTTAAGACAGGTA
AAAAAAAACGACCTTGATTAGCAG	TACGTTAAGTCAGGCC
AAAAAAAAGGCTTCGCTCTGTTGG	TACTAAGTCCTAGTCC
AAAAAAAATGTCCTTCTCTGTTGG	TACTAAGTCTACTAAG
AAAAAAAAGTACAATGAGGACTAC	TACTCAAAGATTCCTT
AAAAAAAATCGTTATGAGGACTAC	TACTCAAAGTTTGGGT
AAAAAAAACTTTAAGCTGAAACTA	TACTCGCTCCAATTAG
AAAAAAAAAACGGACCTGAAACTA	TACTCGCTCCTAGTTT
AAAAAAAATCATCATGAATTAGGT	TACTGACAGTCATTGA
AAAAAAAATGCCTCGACCGGGTTA	TACTGCACAATAACCT
AAAAAAAACGATATAACCGGGTTA	TACTGCACAATTTAGC
AAAAAAAATGTCAGGACGCGTTTC	TACTGGCCAGGTTCAC
AAAAAAAATTACTGCACGCGTTTC	TACTGGCCAGTATGTT
AAAAAAAATAGTAACACGCGTTTC	TACTGGCCAGTTTGTG
AAAAAAAAACGGCTCCTCACCCTC	TACTTCGTCAAAGGCA
AAAAAAAAAAACATGCTCACCCTC	TACTTCGTCCAATAGC
AAAAAAAACTTAATGCTCACATTA	TACTTGTTCTTAGGGT
AAAAAAAATTAACACCTCACATTA	TACTTGTTCTTTAGGA
AAAAAAAATACTCCCTGATCTTAG	TAGACCAGTCAATAGT
AAAAAAAACGTCCTTTGATCTTAG	TAGACCAGTCGTTACT
AAAAAAAAATCCATATGATCTTAG	TAGACCAGTTGAATCG
AAAAAAAATGAACGGTGATCTTAG	TAGACCAGTTTCCGGC
AAAAAAAACTTCCTCACAAGGCCC	TAGCAGGCAGGATAAC
AAAAAAAACTAACCGCTATTGCAC	TAGCATATCTGTGCAG
AAAAAAAATCTGTGATGGGCGGTA	TAGCCGGGTTGACTTC
AAAAAAAATCCTCTACTATACCTG	TAGCCTCTCGCACACA
AAAAAAAATTGAAGGCTATACCTG	TAGCCTCTCGCCTGTT
AAAAAAAAAGTATTGGAGTAGCTG	TAGCCTGAGCGTGCAC
AAAAAAAATATTGCTGAGTAGCTG	TAGCCTGAGGAACACA
AAAAAAAACCTCTGTTGAGGAGGA	TAGCCTTGTCGAAGTC
AAAAAAAAGGTCCATTGAGGAGGA	TAGCCTTGTCGTAATG
AAAAAAAAAGGCTAATGAGGAGGA	TAGCCTTGTGATGAAA
AAAAAAAACCTTACCTGAGGAGGA	TAGCCTTGTTCATCTA
AAAAAAAAGATTTGGACGGTTATG	TAGCGGACAATTAGCT
AAAAAAAACAAGCTCCTCATGCGT	TAGCTAATCCATAAGC
AAAAAAAAACGTTGTCTCATGCGT	TAGCTAATCGATTTAG
AAAAAAAAAGGCGGTTGACAGTGA	TAGCTAGGTGATTACG
AAAAAAAAAAACGGTTGACAGTGA	TAGCTAGGTGGTTAGC
AAAAAAAACAGCGCTTGACAGTGA	TAGCTAGGTGTAATAC
AAAAAAAACAGTTAGGAAAGGATG	TAGCTTAAGTAAGTGG
AAAAAAAACACCAAAGAAAGGATG	TAGCTTAAGTCAATTG
AAAAAAAATCCGGAAACTGGCTAG	TAGCTTGCACATAACT
AAAAAAAAGGTAACTACTGACAAT	TAGGAACCAACAGGAT
AAAAAAAAGGTGAGAACTGACAAT	TAGGAACCAACGTGCT
AAAAAAAATCCGGAAACTGACAAT	TAGGAACCACATAACT
AAAAAAAACTAACTCACTGACAAT	TAGGAACCATGTCGCG
AAAAAAAACGCTTTAACTGACAAT	TAGGAACCATTGTGTG
AAAAAAAATAGCGAGTGCAATGAA	TAGGAGGGTACTTAGG
AAAAAAAAAAGGAGCACTTGCACT	TAGGAGTCATTAAGCT
AAAAAAAAAGAGGGATGCTTAGGT	TAGGCTAGTAAGCACC
AAAAAAAAACGCCTCGAAGTGATT	TAGGCTTAGCTTAGCG
AAAAAAAACCCGAAGGAAGTGATT	TAGGCTTAGGCATTGT
AAAAAAAAGTGATTAGAAGTGATT	TAGGCTTAGGTCCGTA
AAAAAAAATCATCATGAAGTGATT	TAGGCTTAGTCATTGA
AAAAAAAAGAATATCGAAGTGATT	TAGGCTTAGTTAGCTA
AAAAAAAATACGTTACTTCATGAT	TAGGGTTTCAAACTCA
AAAAAAAATTCAGTACTTCATGAT	TAGGGTTTCCCTGGTT
AAAAAAAATTAAGTCCTTCATGAT	TAGGGTTTCGGTTACG
AAAAAAAAGCTATACCTACCTATG	TAGGTTATCCTGTTCA
AAAAAAAAACCGGCTCTACCTATG	TAGGTTATCGCTTGCT
AAAAAAAACTCCTCATGAAACACG	TAGGTTGGTCACGAAC
AAAAAAAAATTGAGGTGAAACACG	TAGGTTGGTGTGAGAG
AAAAAAAAACCTACGTGAGGTGGC	TAGTAACGTTCCTCCT
AAAAAAAACAATCCATGACAATGG	TAGTACGGTCCAAATG
AAAAAAAACTAATGCTGACAATGG	TAGTACGGTGGCTTCC
AAAAAAAAATGTTGTTGACAATGG	TAGTACGGTTACATCC
AAAAAAAAATGCTATTGACAATGG	TAGTACGGTTAGTTGG
AAAAAAAACTGGCTTGATTGAGCA	TAGTAGGAGATTGAGG
AAAAAAAATTGAGGACTGTGATAA	TAGTCAATCAAACACC
AAAAAAAACAGTTTACTGTGATAA	TAGTCAATCCGCACAA
AAAAAAAACTAGCCACTGTGATAA	TAGTCAATCCTGAATA
AAAAAAAAACTGAGCGAAAGCCAC	TAGTGAGAGCTAAAGG
AAAAAAAATTTGTGGTGCCGGTGT	TAGTGGCGTACGCGCA
AAAAAAAACCCAGCATGCCGGTGT	TAGTGGCGTTAATGAC
AAAAAAAACGTTATGTGGCTTCCC	TAGTGTGGTAATCGTG
AAAAAAAAAGCATGATGGCTTCCC	TAGTGTGGTATTGGTG
AAAAAAAATGCACTTACGTTGTCC	TAGTTGTCAGAGGCTA
AAAAAAAAGGTTGGTGATGACTTT	TAGTTTGAGAAGGTGC
AAAAAAAAGCGCAATGATGACTTT	TAGTTTGAGGGTGGAT
AAAAAAAATGGTTAAACCGAATTA	TATAACCCATCTAGCA
AAAAAAAACATAATGACCGAATTA	TATAACCCATGGTTAT
AAAAAAAAATGGATTGATCCTGCA	TATAGCCAGGCCCAGT
AAAAAAAAAATCGTGACCGCAATG	TATAGCTCAGTTTCTC
AAAAAAAACATGGTGACCGCAATG	TATAGCTCATACCCGG
AAAAAAAATCCATAACTCCTACTT	TATATCCTCAGCACGC
AAAAAAAATCAGCACCTCCTACTT	TATATCCTCGAAGTAG
AAAAAAAAAGAGAAGCTCCTACTT	TATATCCTCGTCAAGT
AAAAAAAACTGCTCCCTCCTACTT	TATATCCTCTCACTAT
AAAAAAAATACAAGCGATGATGAC	TATCACAAGCGCTCAA
AAAAAAAAGCTGCAAGATGATGAC	TATCACAAGGCTGTCA
AAAAAAAATCAGTAAACCTTCCTC	TATCACGCAGCAAGAT
AAAAAAAAGAACCGCACCTTCCTC	TATCACGCAGGAACAT
AAAAAAAATTACCCAACCTTCCTC	TATCACGCATTATGAC
AAAAAAAAGGCTAGCACCGAAGTC	TATCCAGCAAGGTGGC
AAAAAAAAAAGACAAACCGAAGTC	TATCCAGCATCCTAGA
AAAAAAAATCGTACCGACATAGTG	TATCCGGAGCCAAATC
AAAAAAAAAGAAACCTGAATCGTT	TATCGAGGTCATTAGG
AAAAAAAATGGTCATTGAATCGTT	TATCGAGGTGCTAGCG
AAAAAAAATTACCTTTGAATCGTT	TATCGAGGTGTCCAGG
AAAAAAAATAGACAATGAATCGTT	TATCGAGGTTAAATGC
AAAAAAAACTCATTGACCTTTAGC	TATCGCACAAATACCT
AAAAAAAATTTAGCTGATAAGCTG	TATCGCGAGTAATCCA
AAAAAAAACTTAGCTACAGTAAGA	TATGAAGCAAAGGTAC
AAAAAAAAAGAAGTAACAGTAAGA	TATGAAGCACGTGCTG
AAAAAAAAAGCTTGAACAGTAAGA	TATGAAGCAGCTCATA
AAAAAAAAGCAACATACAGTAAGA	TATGAAGCAGTGAACG
AAAAAAAACAACAAGCTTTGTAAC	TATGACATCCCTTGCG
AAAAAAAACTTCATGACCTTTGAC	TATGACTCAGGCCTTG
AAAAAAAACTTAGCTACCGTAAAT	TATGCATCAAAGGTAC
AAAAAAAAAACGGGAACCGTAAAT	TATGCATCAACTAACT
AAAAAAAAGCACCTTACCGTAAAT	TATGCATCAATTGACT
AAAAAAAAATACCGAACCGTAAAT	TATGCATCACCAGCAT
AAAAAAAAGCTCAGGACCGTAAAT	TATGCATCACTGGCCA
AAAAAAAAGCGATTAACCGTAAAT	TATGCATCAGAACCGA
AAAAAAAAAATTTGCTGAATCCAT	TATGGATGTTGAGCCG
AAAAAAAATTAAGGTACTTCCTTT	TATGGCCCAGTAGGTG
AAAAAAAATCCTTAAGATTGAGTG	TATGGTCAGCACAGAA
AAAAAAAACCTCCTCGATTGAGTG	TATGGTCAGGACAATG
AAAAAAAAGCTTAAAGATTGAGTG	TATGGTCAGGCTACAT
AAAAAAAACATTCCTCTATCGCAT	TATGTGATCATGAGCT
AAAAAAAAGCACCTTACCAAACAT	TATTAGCCAATTGACT
AAAAAAAACTTCGTAACCAAACAT	TATTAGCCACAACAAA
AAAAAAAAAACTTCGCTTCCAGCA	TATTAGGTCAGCATTA
AAAAAAAACGGCAAGCTTTAACCA	TATTCGTTCCAAATCA
AAAAAAAACGCAATCCTTTAACCA	TATTCGTTCGAAGTGA
AAAAAAAATTCGTAACTTTAACCA	TATTCGTTCTATGACA
AAAAAAAAGGGACTCACAAAGGTA	TATTGACCAAGCGAGC
AAAAAAAACTTACTGACAAAGGTA	TATTGACCAGCACGTT
AAAAAAAACAGAACCACAAAGGTA	TATTGACCAGCCAGAA
AAAAAAAAGCTACAAACAAAGGTA	TATTGACCAGGCTACT
AAAAAAAATGTTCCTCTGGATCCC	TATTTGCTCTGTTGCC
AAAAAAAATAACCTTGAAGCCTCC	TATTTGGAGGAACCAA
AAAAAAAAGCTTAAAGAAGCCTCC	TATTTGGAGGCTACAT
AAAAAAAACATAGGTGATTTGGGA	TCAAACCAGGCATGTT
AAAAAAAAAACTTCGCTCATAGCC	TCAACAATCAGCATTA
AAAAAAAAGACTAGGCTCATAGCC	TCAACAATCCCGCCTA
AAAAAAAAAACCTGTCTCATAGCC	TCAACAATCCCTCATA
AAAAAAAAAGTCCCGCTCATAGCC	TCAACAATCCTGCGAA
AAAAAAAAGGTCATTCTCATAGCC	TCAACAATCGCTAGAT
AAAAAAAACTTAATGCTCATAGCC	TCAACAATCTTAGGGT
AAAAAAAATTGGTAAACCTCCTAA	TCAAGAACACTAAATC
AAAAAAAACCCGGTTACCTCCTAA	TCAAGAACAGGCTTCG
AAAAAAAAGCTGGTGACCTCCTAA	TCAAGAACATGCTATG
AAAAAAAACTTAGCGCTTGTGACC	TCAAGACTCTCCTCAA
AAAAAAAACTATTGTGAGCATATA	TCAAGCTAGACTAAGG
AAAAAAAAACAGGCTGAGCATATA	TCAAGCTAGGTCGAGG
AAAAAAAAAAATGCTGATTCCGCA	TCAAGGAAGAGAGGAG
AAAAAAAAACAGCCAGATTCCGCA	TCAAGGAAGCTAAGTC
AAAAAAAACCAGAAACTACGGGTA	TCAAGGTTCCTAAGTA
AAAAAAAAGCCTAATCTCAAAGGT	TCAAGTATCGTTAGTA
AAAAAAAAAAGTAACCTCAAAGGT	TCAAGTATCTTGATGA
AAAAAAAACCTAGCTGAGTGATGC	TCACATAAGGCATGAA
AAAAAAAAGGGAACAACTGGCATG	TCACCGGCACTCGCTC
AAAAAAAAATGTTTCACTGGCATG	TCACCGGCAGCTACGT
AAAAAAAAAAGTTTGGAAGCCAGT	TCACCTCAGCGGATTT
AAAAAAAACGATTGAGAAGCCAGT	TCACCTCAGGTGAAAT
AAAAAAAAAGGGTATTGCTGAATC	TCACCTGGTGTGCACG
AAAAAAAACTCACAATGCTGAATC	TCACCTGGTGTTCCCA
AAAAAAAAGATTACGACGGTTAGT	TCACTGACATGTTGTG
AAAAAAAATAATCCGTGGTTATGT	TCAGCAAGTTAACAGT
AAAAAAAAATGCGCTTGGTTATGT	TCAGCAAGTTCCAGGG
AAAAAAAACAGCTACCTATCCTCC	TCAGCCTTCCCGTTGT
AAAAAAAATGCAGCTCTATCCTCC	TCAGCCTTCCCTCAGT
AAAAAAAAATTCCTTCTATCCTCC	TCAGCCTTCTCGCCCA
AAAAAAAAGGCGGTTACAATTTCC	TCAGGTCCAAGGACCA
AAAAAAAACATGATGGAAGCTTGG	TCAGGTTAGGCCTTAG
AAAAAAAAGATTTGAGAAGCTTGG	TCAGGTTAGGGTCTAT
AAAAAAAAAGCTAATGAAGCTTGG	TCAGGTTAGTGGACAA
AAAAAAAAACACTTGCTCCTCTCG	TCAGTAATCAACAAGG
AAAAAAAATCTAAGTCTCCTCTCG	TCAGTAATCACTCGCT
AAAAAAAAGCCTGGTCTCCTCTCG	TCAGTAATCCGCAAAT
AAAAAAAACGGCTATCTCCTCTCG	TCAGTAATCCTCCATA
AAAAAAAATATTAGCCTCCTCTCG	TCAGTAATCTATCGCC
AAAAAAAACTTAGCGCTCCTCTCG	TCAGTAATCTCCTCAA
AAAAAAAAGTGCGAGTGATATTCG	TCAGTGAGTATTGAGT
AAAAAAAAGACCAGGTGATATTCG	TCAGTGAGTTTCGCGC
AAAAAAAATGCACAGACGTCCATC	TCATAACCACCGGCTA
AAAAAAAAAGACCATACGTCCATC	TCATAACCAGCTAACC
AAAAAAAACTACTTCCTACAACAA	TCATACTTCATTGCGG
AAAAAAAACCAGGGACTACAACAA	TCATACTTCCCTCTAA
AAAAAAAAGTTGCATCTACAACAA	TCATACTTCTAAGGTC
AAAAAAAATAGCTTACTTCAGGAA	TCATGCCTCAATCTAG
AAAAAAAAGCGATAGCTTCAGGAA	TCATGCCTCTAATTGG
AAAAAAAAGTTAAAGCTTCAGGAA	TCATGCCTCTCGCCTG
AAAAAAAAGGCTAGACTTAGGAGT	TCATGTTTCACTAAGC
AAAAAAAAACGCTTACTTAGGAGT	TCATGTTTCATGAAGG
AAAAAAAACGCTATGCTTAGGAGT	TCATGTTTCCACCTTA
AAAAAAAATCAAATCCTTAGGAGT	TCATGTTTCCGGAACC
AAAAAAAATAGCTATCTACTGGCC	TCATTACTCCGGCTAA
AAAAAAAATTAGGTTCTACTGGCC	TCATTACTCCTTCGTA
AAAAAAAAACGCGAACTAGTAACA	TCATTGTTCGAGGAGT
AAAAAAAAAAATACGCTAGTAACA	TCATTGTTCTAACTGA
AAAAAAAATGTTCCTCTAGTAACA	TCATTGTTCTGTTGCC
AAAAAAAAGCAGGCATGCTTGCGG	TCATTTGGTTCCGGCT
AAAAAAAAGCCACTTACCTCCTCT	TCCACAACACCCTCAC
AAAAAAAATGGATTAACCTCCTCT	TCCACAACACCTGGTG
AAAAAAAATGATCCTACCTCCTCT	TCCACAACACTGGCTG
AAAAAAAAAAGATAGACCTCCTCT	TCCACAACAGCTTAGC
AAAAAAAAGGTGCGTACCTCCTCT	TCCACAACAGGGAGGA
AAAAAAAACGCATCCACCTCCTCT	TCCACAACAGTAGGAT
AAAAAAAAAACCTTTACCTCCTCT	TCCACAACATAGACCC
AAAAAAAAGCAATTGACCTCCTCT	TCCACAACATTGACAT
AAAAAAAACATTTGTGAGGCCCTT	TCCAGCAAGTCACCAG
AAAAAAAAGATACTCCTTGAGCAA	TCCAGGATCCGCAACA
AAAAAAAATACATACCTTGAGCAA	TCCAGGATCGAGCTAT
AAAAAAAACACCCTCCTTGAGCAA	TCCAGGATCTAGCTAA
AAAAAAAACGCAAGGCTTGAGCAA	TCCAGGATCTGCAACG
AAAAAAAATGCACAGACCTCGACC	TCCAGGTCACCGGCTA
AAAAAAAAGTGGATTACCTCGACC	TCCAGGTCAGCAACAG
AAAAAAAAAAAGCTTGATTCATTG	TCCATAAAGGTACCGC
AAAAAAAATCATCATGATTCATTG	TCCATAAAGTCATTGA
AAAAAAAACGACTTGCTTACTTCC	TCCATATTCAAGTGTC
AAAAAAAATGCTGTGCTTACTTCC	TCCATATTCCTGATTT
AAAAAAAACGGCAAGCTCTATATG	TCCATCATCCAAATCA
AAAAAAAATGGTTATCTCTATATG	TCCATCATCCTAAATG
AAAAAAAAAAGCTAACTCTATATG	TCCATCATCGCAAACT
AAAAAAAAGTGAGCACTCAAGGTA	TCCATGCTCATGTCAA
AAAAAAAAGTGCAAGCTCAAGGTA	TCCATGCTCCGCCTAT
AAAAAAAACGTAAAGCTTAGCTAT	TCCATTGTCAATGTCA
AAAAAAAATTAATGGACGTTACTT	TCCCGGACATTAGCCA
AAAAAAAAGGCTTAGGAGTCAAGC	TCCCGTTAGACACTTA
AAAAAAAACGATTAGGAGTCAAGC	TCCCGTTAGCTTGCTC
AAAAAAAAGGTAACTACATGATCG	TCCCTCACAACAGGAT
AAAAAAAAAGTTGTCCTGGCTATT	TCCCTGGTCAATTACG
AAAAAAAAAGTGAATCTAAGGACC	TCCGGTTTCAAGCCTG
AAAAAAAACATTAGTCTAAGGACC	TCCGGTTTCAATGACC
AAAAAAAATTACCGGCTAAGGACC	TCCGGTTTCCCTCGCA
AAAAAAAAAGTAGCGCTAAGGACC	TCCGGTTTCTTAGGAC
AAAAAAAACCAGGCTTGCTCCTAC	TCCTAGTGTCATGCAA
AAAAAAAACAATTGGGAATAACGT	TCCTCACAGCATGCAT
AAAAAAAACTAGTTTGAATAACGT	TCCTCACAGGTGCTGC
AAAAAAAAAGGGTGGGAATCGCTT	TCCTCTAAGAATGACG
AAAAAAAAGGTCCAAGAATCGCTT	TCCTCTAAGCGCCTAA
AAAAAAAAGTAATTGGAATCGCTT	TCCTCTAAGGCGCTTA
AAAAAAAAGCTGCAAGAATCGCTT	TCCTCTAAGGCTGTCA
AAAAAAAATTACCCGGAATCGCTT	TCCTCTAAGTGAGAGC
AAAAAAAAAGTTGTCCTTCCTGAG	TCCTGGTTCAATTACG
AAAAAAAAGTGGACACTTCCTGAG	TCCTGGTTCACTTCAT
AAAAAAAAATATGCGACTAGTCTC	TCCTGTTCAGCAAGGC
AAAAAAAAGGTACTAACTAGTCTC	TCCTGTTCAGTCTAAT
AAAAAAAATGGAGCGCTCCAACCA	TCCTTAGTCCGTAAAC
AAAAAAAAGGGCAATCTCCAACCA	TCCTTAGTCCGTGACA
AAAAAAAACTTGAGCCTCCAACCA	TCCTTAGTCGGTTCCT
AAAAAAAACCTTCATCTCCAACCA	TCCTTAGTCGTTAGCG
AAAAAAAAATATAGCGACAACATG	TCCTTCAAGTTAACCA
AAAAAAAACCTAGCTGATCCTTGG	TCCTTGCAGGCATGAA
AAAAAAAAAAACCCAACTCACACT	TCCTTTACACCTCGCT
AAAAAAAATATGATGACTCACACT	TCCTTTACATAGCTGC
AAAAAAAAGATTACGACTCACACT	TCCTTTACATGTTGTG
AAAAAAAAGTCTAGCTGTAACCCA	TCGACAAGTGGATGTC
AAAAAAAAGAGCAATTGTAACCCA	TCGACAAGTTCCATTA
AAAAAAAAGACACCTTGTAACCCA	TCGACAAGTTTGGGCG
AAAAAAAAACCCGCTGAAACCGTG	TCGATTAAGCAAGGTA
AAAAAAAATCCCTTTGAAACCGTG	TCGATTAAGGCATTAC
AAAAAAAAAGAGGCGGAAACCGTG	TCGATTAAGGCCTAAT
AAAAAAAACTGCTGTGAAACCGTG	TCGATTAAGGGATGAC
AAAAAAAAACGGTTCTGCGTGTTA	TCGCATTGTAGCTAAT
AAAAAAAAGTGCACTTGCGTGTTA	TCGCATTGTGCTGGTG
AAAAAAAAAACGGACCTGGCATGA	TCGCCCATCCTAGTTT
AAAAAAAATTGTTGGTGTGCTGAT	TCGCGAGGTAGGTTTG
AAAAAAAATCCTGAATGTGCTGAT	TCGCGAGGTTATAGCG
AAAAAAAACTGAGTGACGCTAATG	TCGCGCACATCCATCT
AAAAAAAATTGGTCATGCTCAGGC	TCGGTAAGTTGGTTGA
AAAAAAAACCTTATTTGCTCAGGC	TCGGTAAGTTGTTCAC
AAAAAAAAGAAACCTACAGAATGA	TCGGTTACAGGCATCT
AAAAAAAATCCAATACTTTGAGGA	TCGGTTCTCTAATCAG
AAAAAAAACTTCATGACCCTTCTC	TCGTAATCAGGCCTTG
AAAAAAAAGGTTGGTGAACCTGGA	TCGTTAAAGAAGGTGC
AAAAAAAAAAATGTCGAACCTGGA	TCGTTAAAGCCTGTTC
AAAAAAAAAGTTTGAGAACCTGGA	TCGTTAAAGTAACCAC
AAAAAAAAGCAGTTAACTAAGGCC	TCGTTAGCAACTAGAA
AAAAAAAAAACCACAACTAAGGCC	TCGTTAGCAAGGTCGA
AAAAAAAATGCATTACTACAAACA	TCGTTATTCAGCAAAG
AAAAAAAAATCAAGACTACAAACA	TCGTTATTCGTCATTT
AAAAAAAACCTAGCGTGCATCCCT	TCTAACCGTTAGGACC
AAAAAAAAAGCCAGGTGCATCCCT	TCTAACCGTTTGCGAA
AAAAAAAACAAGGGTTGCATCCCT	TCTAACCGTTTGTGGA
AAAAAAAACTGCTAATGGATGCAA	TCTAAGGGTTACAAAC
AAAAAAAAGTAGGATTGGATGCAA	TCTAAGGGTTCCGGGA
AAAAAAAAACGTTGTCTCAATGAG	TCTAATCTCGATTTAG
AAAAAAAATGATTTGCTCAATGAG	TCTAATCTCGTTAAGC
AAAAAAAAACTCATGCTCAATGAG	TCTAATCTCGTTTCTG
AAAAAAAAATACCGAACTTATCGC	TCTACCTCACCAGCAT
AAAAAAAACTTAAGAACTTATCGC	TCTACCTCATAATTGC
AAAAAAAACTTACGTACTTATCGC	TCTACCTCATCCGTAA
AAAAAAAATTTAGGCTGTGCGCGT	TCTACTAGTGGAGCAA
AAAAAAAAGTCTTTAACCTTGAGG	TCTAGCACACAATGTT
AAAAAAAATAACCGGACCTTGAGG	TCTAGCACACGTAAGG
AAAAAAAATTTATGGCTAAGCTAA	TCTATGTTCGGTACGC
AAAAAAAAGGTTCATCTAAGCTAA	TCTATGTTCTTAATGG
AAAAAAAAATTGTCTACCCAACCC	TCTCAAGCAATCCTGA
AAAAAAAATTTGGAAACCCAACCC	TCTCAAGCACCAAAGG
AAAAAAAACGAGCTAACCCAACCC	TCTCAAGCATGACTAT
AAAAAAAAAGATTAGCTTATCGCG	TCTCAATTCATGCGTG
AAAAAAAATGAGCGCGAATCACTC	TCTCACCAGCTAATCA
AAAAAAAATGGTCAAGAATCACTC	TCTCACCAGTTTGCGG
AAAAAAAAATAAAGGACTAATCAG	TCTCGCCCACTAGGTC
AAAAAAAAGCCAAATACTAATCAG	TCTCGCCCACTTCATC
AAAAAAAAGAAACCTACTAATCAG	TCTCGCCCAGGCATCT
AAAAAAAATACTCACACTAATCAG	TCTCGCCCATCCCGCT
AAAAAAAAAGTGAATCTTCGCTTT	TCTGGCTTCAAGCCTG
AAAAAAAAGAAAGCCCTTCGCTTT	TCTGGCTTCAGGATGA
AAAAAAAAACGCGAACTTCGCTTT	TCTGGCTTCGAGGAGT
AAAAAAAAACGTTGTCTTCGCTTT	TCTGGCTTCGATTTAG
AAAAAAAAGTGATGGCTTCGCTTT	TCTGGCTTCTTGCTAT
AAAAAAAATCACGTTACTAATCCC	TCTGTGACAATCCCTT
AAAAAAAACAGGACTACTAATCCC	TCTGTGACAATTGAAG
AAAAAAAAGGGAGTAACTAATCCC	TCTGTGACAGCATGAG
AAAAAAAATAATCCGTGGTAAGGT	TCTTAGCGTTAACAGT
AAAAAAAATGGCTATTGGTAAGGT	TCTTAGCGTTCACTGT
AAAAAAAATTGGCCACTACGGATG	TCTTAGTTCCGGTTGA
AAAAAAAACCCAGTACTACGGATG	TCTTAGTTCTTGCAAA
AAAAAAAAACTAACTTGAATCGAG	TCTTCAAGTGTTAGCA
AAAAAAAACAGCGCTTGTGGCTTA	TCTTGACGTGTAATAC
AAAAAAAATCACCATACATAAAGG	TCTTGTCCAAGACTCC
AAAAAAAAGCATAGCGATCCTTTC	TCTTTGTAGGAGGGTT
AAAAAAAAAGTCATTTGTCAGGGA	TGAAACTGTATGTGGC
AAAAAAAACTACTAGTGTCAGGGA	TGAAACTGTCCAAGAC
AAAAAAAACTGAGCAACGATTCAG	TGAACAACAGTAGCCT
AAAAAAAATAGCACAGAAGTCAGC	TGAACAGAGGACCAGG
AAAAAAAACCTAACCGAAGTCAGC	TGAACAGAGGACCTGC
AAAAAAAACGTATTTGAAGTCAGC	TGAACAGAGGGCTTAT
AAAAAAAATGCTTATGAAGTCAGC	TGAACAGAGTAAACCC
AAAAAAAAATGCTTCGACTAAGAC	TGAAGCAAGCTCCTTA
AAAAAAAAAGTTGTCCTTGAGGGC	TGAAGGATCAATTACG
AAAAAAAACCAGAAACTTGAGGGC	TGAAGGATCCTAAGTA
AAAAAAAATGCGTGTCTTGAGGGC	TGAAGGATCCTGGTGA
AAAAAAAAAATCACAGATGGAGGA	TGAAGTGAGTTATGGC
AAAAAAAAGAGAAGGTGCGAGTTT	TGACCAAGTACCCACC
AAAAAAAAAGCTAAGTGCGAGTTT	TGACCAAGTCCTTAGT
AAAAAAAAGCTGTCATGTTTACGG	TGACCTTGTCAAGTAT
AAAAAAAACATGAAATGTTTACGG	TGACCTTGTCGTAAAT
AAAAAAAAATTGAGGTGTTTACGG	TGACCTTGTGTGAGAG
AAAAAAAACTAGGTTTGTTTACGG	TGACCTTGTTGGCCGA
AAAAAAAACTTGAATCTTAGCCAC	TGACTCCTCCCGCAAA
AAAAAAAACGGATTAGAATCGTTC	TGACTTAAGGTTACGT
AAAAAAAAGCACAAATGTGGCCCA	TGACTTCGTTGCATCT
AAAAAAAAGTAACACACGCTTAAG	TGAGAACCAAACAACA
AAAAAAAAATGGCTAACGCTTAAG	TGAGAACCATTGTGCA
AAAAAAAAAGTTACAGATGCGATA	TGAGCAAAGCTAGAAG
AAAAAAAAGGTCATGGATGCGATA	TGAGCAAAGGACTAAG
AAAAAAAAATGGGCGTGTGGACAG	TGAGCCGGTAGGTGTC
AAAAAAAAGTAGCTAACCTTGCTA	TGAGGCACAAGGTAAC
AAAAAAAATCACGTTACCTTGCTA	TGAGGCACAATCCCTT
AAAAAAAATCCTCCTACTGTCAGG	TGAGGGCCATAATCAC
AAAAAAAATCGCTATACCGCAAAC	TGAGGTGCAATGAAGC
AAAAAAAAGTTTGTCGACAAATGC	TGAGTGAAGAAAGCAT
AAAAAAAACAAGCCTCTCAAAGAC	TGATCAATCTGTGCCT
AAAAAAAATGCAACAGACGTAATG	TGATCACAGAGGCTAA
AAAAAAAAACCAAATGACGTAATG	TGATCACAGCTATTAG
AAAAAAAAATATAGCGACGTAATG	TGATCACAGTTAACCA
AAAAAAAATCAGTTTGACGTAATG	TGATCACAGTTAGGCT
AAAAAAAACTCCTCATGGGTGAGC	TGATCAGGTCACGAAC
AAAAAAAAGGGCATGTGGGTGAGC	TGATCAGGTTAGCAGC
AAAAAAAAATGCTATTGCCGGTAC	TGATCGAGTTAGTTGG
AAAAAAAATCGGTATTGCCGGTAC	TGATCGAGTTTAGTCC
AAAAAAAAACTGCAAACCATTACC	TGATGAACAGTTATGT
AAAAAAAATCCTCAAACCATTACC	TGATGAACATCAGTAT
AAAAAAAAGCTGGTTTGGCTCATG	TGATGATGTACTGAAT
AAAAAAAAGGTCCATTGGCTCATG	TGATGATGTCGTAATG
AAAAAAAAGGCATGACTATTCAGC	TGATTAGTCCAGGTTG
AAAAAAAATGTTGCGCTATTCAGC	TGATTAGTCTAGCGTG
AAAAAAAATGCTTATGAGCCACCT	TGATTCAAGTAAACCC
AAAAAAAAGTGGTGACTTTAGCTA	TGCAATATCCGCCTCA
AAAAAAAATCGTGACCTTTAGCTA	TGCAATATCCTAATAG
AAAAAAAAAACAGCTACGTGCTGG	TGCACACCAGAGAGCC
AAAAAAAAAGACCATACGTGCTGG	TGCACACCAGCTAACC
AAAAAAAATACGCACCTTTCTTCG	TGCACCTTCACTCAAA
AAAAAAAAGGCATTTCTTTCTTCG	TGCACCTTCATTAGTG
AAAAAAAACTAAGGACTTTCTTCG	TGCACCTTCATTATGG
AAAAAAAAGGAATATCTTTCTTCG	TGCACCTTCCAAACAC
AAAAAAAACAAGTCCCTTTCTTCG	TGCACCTTCGTTACTT
AAAAAAAAGCTCCCTTGTCCATAG	TGCACTTGTCTCACTG
AAAAAAAACGCATTATGTCCATAG	TGCACTTGTGGATTAT
AAAAAAAACCCTAAGCTAGGCTTT	TGCAGGCTCTCAATTC
AAAAAAAACACTATACTTAAAGCG	TGCATCCTCTGGCATG
AAAAAAAATTCGCGACTTAAAGCG	TGCATCCTCTGTAATG
AAAAAAAACAGGAACTGCGACTTA	TGCATGAGTACTGATG
AAAAAAAATGCTCTCTGCGACTTA	TGCATGAGTTGCTTCG
AAAAAAAACCTCTGTTGTGGGTGA	TGCCATTGTCGAAGTC
AAAAAAAACACATACTGTGGGTGA	TGCCATTGTGCAACTA
AAAAAAAAGAGCGGTTGTGGGTGA	TGCCATTGTTAAGCGC
AAAAAAAATGCAAGGTGTGGGTGA	TGCCATTGTTAGCGTA
AAAAAAAAATGCGCTTGTGGGTGA	TGCCATTGTTCCAGGG
AAAAAAAAGCGTCTATGTGGGTGA	TGCCATTGTTTGAGCA
AAAAAAAATCTCAATGAGGTTGGT	TGCCGGTAGGTCATTA
AAAAAAAACGATAAGCTTTAGGAG	TGCCTGTTCCCATAGG
AAAAAAAAGCGACTCCTTTAGGAG	TGCCTGTTCGCTATGG
AAAAAAAATCGTTATGAGCTTACT	TGCGATTAGTTTGGGT
AAAAAAAACGATATAACAATGTCG	TGCGGTTCAATTTAGC
AAAAAAAATGACAATACAATGTCG	TGCGGTTCACCTCACC
AAAAAAAATAACCGGACAATGTCG	TGCGGTTCACGTAAGG
AAAAAAAACCGCTTAGACTCAATT	TGCTAACAGTAAAGGT
AAAAAAAACCTAAGGACATCCAGA	TGCTAGCCATTGTCCT
AAAAAAAACACGGATACAGTAAAG	TGCTCAACAGGAATCG
AAAAAAAAAATCGTGACAGTAAAG	TGCTCAACAGTTTCTC
AAAAAAAACACCAACCTACCGGTC	TGCTCACTCAATGTGC
AAAAAAAATTTGCGGCTACGCCAC	TGCTCCGTCGCAATCG
AAAAAAAATAAGGTCGATTAGTTC	TGCTCTCAGCCTGACA
AAAAAAAAATGTGCGGATTAGTTC	TGCTCTCAGCCTGTGA
AAAAAAAAGTAATGTGATTAGTTC	TGCTCTCAGGAGGACT
AAAAAAAACGATTGAGATTAGTTC	TGCTCTCAGGTGAAAT
AAAAAAAAATGACTCCTCAAGACA	TGCTGGATCATAACGC
AAAAAAAATGAATCTCTCAAGACA	TGCTGGATCGGCCAGT
AAAAAAAAGCCTAATCTCAAGACA	TGCTGGATCGTTAGTA
AAAAAAAAGTACAATGACTGATGA	TGCTTAAAGATTCCTT
AAAAAAAAGTATTGCCTACGCCCA	TGCTTCATCGGTCAGC
AAAAAAAAATTTCGCGACCGGCAA	TGCTTCCAGCAAGGAC
AAAAAAAATAACGTGGACCGGCAA	TGCTTCCAGTCAATCA
AAAAAAAAGGATTAGTGGCTTTGG	TGCTTGTGTATTCGTC
AAAAAAAATCTTTGTTGTAGCCAT	TGCTTTAGTCTCAGCC
AAAAAAAACACAGGATGTAGCCAT	TGCTTTAGTTATGTGG
AAAAAAAAGCACAAATGTAGCCAT	TGCTTTAGTTGCATCT
AAAAAAAACCATCACGAACAGGCT	TGGAACAAGCTACTGG
AAAAAAAAACGCCTCGAACAGGCT	TGGAACAAGCTTAGCG
AAAAAAAACCTAGCTGAACAGGCT	TGGAACAAGGCATGAA
AAAAAAAATAACCTTGAAATATGC	TGGACAAAGGAACCAA
AAAAAAAACATAGGTGAAATATGC	TGGACAAAGGCATGTT
AAAAAAAATCAGTTTGAAATATGC	TGGACAAAGTTAGGCT
AAAAAAAATGAGGCATGTCCCGGA	TGGACCGGTGATCATG
AAAAAAAATCCTGAATGTCCCGGA	TGGACCGGTTATAGCG
AAAAAAAACTTCTATTGTTCACTT	TGGACTAGTGAGCACT
AAAAAAAATTGCTTAGATACTTAC	TGGATTCAGACAAAGT
AAAAAAAAAAACCCGGATACTTAC	TGGATTCAGGCGTAAA
AAAAAAAAAATCCGGGATACTTAC	TGGATTCAGTTAGACC
AAAAAAAAATGACTTTGCATGTTG	TGGATTGGTTATCCGT
AAAAAAAATACAACAACTCAATAG	TGGCCATCAACTAGCC
AAAAAAAAGTAGTCAACTCAATAG	TGGCCATCAGCACCAT
AAAAAAAACAGAGGGACTCAATAG	TGGCCATCAGTTAGCC
AAAAAAAACTACCGCACTCAATAG	TGGCCATCATTTGCTC
AAAAAAAATTCGCGCACTCAATCC	TGGCCTGCAAACCTAT
AAAAAAAAACCTTGCACTCAATCC	TGGCCTGCAAGCTTTG
AAAAAAAAATTGTCTACTCAATCC	TGGCCTGCAATCCTGA
AAAAAAAAATAGATGCTCCGCAAT	TGGCCTTTCTACCTGC
AAAAAAAAACCGCCACTCAAACCC	TGGCGGTTCATGTGGT
AAAAAAAACTAGCCTGAAAGGACA	TGGCTATAGAGCAAGC
AAAAAAAAAGTAGGTTGATGAGGT	TGGCTTTGTCGCATAA
AAAAAAAACTCGAGCTGTTGTGGT	TGGGCATGTAACTACG
AAAAAAAAGAGGGTGGAAGTTATG	TGGGCCTAGGGACGCA
AAAAAAAACCTGGAAACCCTCCTT	TGGTAAACAAAGCTAA
AAAAAAAATACGCCACTTGGTCCA	TGGTCAGTCCCTGGAA
AAAAAAAAACAGAATCTTGGTCCA	TGGTCAGTCGATATTG
AAAAAAAAAGGTTAACTTGGTCCA	TGGTCAGTCTGTAAGC
AAAAAAAAGAGGTGGGAAGTAGCC	TGGTCATAGAGGGACT
AAAAAAAAACAATTGGAAGTAGCC	TGGTCATAGCACAGGG
AAAAAAAACTACTTCCTTAACCGC	TGGTCCTTCATTGCGG
AAAAAAAAGTCTTGACTGACCAGA	TGGTGATTCATGACCG
AAAAAAAACGCAGGACTGACCAGA	TGGTGATTCGGCTAGC
AAAAAAAACCTAAGCCTGACCAGA	TGGTGATTCTAACCAA
AAAAAAAATTTAGTGCTGACCAGA	TGGTGATTCTAAGTCA
AAAAAAAAAGTCATCCTTGATGTT	TGGTGCATCGTGCTAG
AAAAAAAAATAGCCTCTAAGTCCT	TGGTTAATCACGCGGT
AAAAAAAAGGCATGACTAAGTCCT	TGGTTAATCCAGGTTG
AAAAAAAACGCAGGACTAGAAACT	TGGTTCCTCGGCTAGC
AAAAAAAAAGGCCTTTGTTGCAGT	TGGTTCTGTGTGTGGT
AAAAAAAATCAAACCTGCAATAGA	TGGTTGAGTAGCTGCG
AAAAAAAACTCCATAACTATAACG	TGTAAAGCAAGATTCT
AAAAAAAACGTAAATACGTGCAAT	TGTAACTCAGCTAATT
AAAAAAAACCATCCTTGCAATGTC	TGTAAGTGTTAGAGGG
AAAAAAAAAGCCAAATGCAATGTC	TGTAAGTGTTCTTTAG
AAAAAAAAAGCTTGTCTAGATTGA	TGTAATGTCATTCATC
AAAAAAAATATAACCCTAGATTGA	TGTAATGTCCTGAGTG
AAAAAAAAATTCCTTCTAGATTGA	TGTAATGTCTCGCCCA
AAAAAAAACAAGCCTCTAGATTGA	TGTAATGTCTGTGCCT
AAAAAAAATGTTCCTCTAGATTGA	TGTAATGTCTGTTGCC
AAAAAAAAGCACAAATGGTTTGGC	TGTATCCGTTGCATCT
AAAAAAAAATGAGAAACTAATCGA	TGTATCGCACAATACT
AAAAAAAACACCATTACTAGGACC	TGTCAATCATGCATAT
AAAAAAAACATGATGGAGGAGGAC	TGTCAGTAGGCCTTAG
AAAAAAAATCATGGAGATCAGGTA	TGTCATAAGACCATAC
AAAAAAAAGCATAGCGATCAGGTA	TGTCATAAGGAGGGTT
AAAAAAAACAGTGTGACCTTAGAA	TGTCCTTCACGAACAG
AAAAAAAACCGGATAACCTTAGAA	TGTCCTTCATGAATAG
AAAAAAAATAAACCAACCTTAGAA	TGTCCTTCATTGCAGC
AAAAAAAACATAAGTACTACGGGT	TGTGAAACAAATTCGT
AAAAAAAAGGTTGTAACTACGGGT	TGTGAAACAATCGCAC
AAAAAAAAATCCAAGACTACGGGT	TGTGAAACATACTCCT
AAAAAAAAGCAATTGACTACGGGT	TGTGAAACATTGACAT
AAAAAAAATAGCGGATGGCATGTC	TGTGCAAGTCAAGTGC
AAAAAAAACGCCAACTGGCATGTC	TGTGCAAGTCATTACC
AAAAAAAACAGATTCTGGCATGTC	TGTGCAAGTCTTGCAT
AAAAAAAATGTAACCTGTTGTCAG	TGTGCGGGTTGCCTCA
AAAAAAAAAAGGAGCACTTTAAGG	TGTGGAGCATTAAGCT
AAAAAAAATATCCATGATTGGCGG	TGTGGCCAGAGCCGGA
AAAAAAAATCCACCTTGCAATCGT	TGTGGCGGTAAGGTTT
AAAAAAAATGGTGTGACGTAAACC	TGTGGCTCACAAAGGT
AAAAAAAACGGACAATGCAGTAAA	TGTGTGAGTTAAGGTT
AAAAAAAACGAGTTAGATATTACC	TGTGTTAAGCACGATT
AAAAAAAATGAGCGCGATATTACC	TGTGTTAAGCTAATCA
AAAAAAAATAGGCTAGACAAAGCT	TGTTAGCAGGAAGCAC
AAAAAAAAGGAGGGTGACAAAGCT	TGTTAGCAGGGCCATC
AAAAAAAAGTACTGGGACAAAGCT	TGTTAGCAGTCTGGGC
AAAAAAAAGTTCACTGATTGCTAT	TGTTATGAGCATGAAG
AAAAAAAAAGTACCGGATTGCTAT	TGTTATGAGTATGTGC
AAAAAAAATGGTCAAGATTGCTAT	TGTTATGAGTTTGCGG
AAAAAAAATTCCTTGCTAGGCTGA	TGTTCATTCCCGTTTA
AAAAAAAAGCTATACCTAGGCTGA	TGTTCATTCCTGTTCA
AAAAAAAAGTCCTGGCTAGGCTGA	TGTTCATTCGCTAGCA
AAAAAAAAGCTAGTAACGTTTACT	TGTTCCTCACCTAATG
AAAAAAAAGGTGCGTACGTTTACT	TGTTCCTCAGGGAGGA
AAAAAAAAGAACCGCACCTACGGA	TGTTGCACAGGAACAT
AAAAAAAATGTAATGACCTACGGA	TGTTGCACATTAAAGG
AAAAAAAAGTAACACACACTTAGG	TGTTGGCCAAACAACA
AAAAAAAATTACTGCACACTTAGG	TGTTGGCCAGTATGTT
AAAAAAAAGGTTATGACACTTAGG	TGTTGGCCATGAGCAG
AAAAAAAACGCTTTAACACTTAGG	TGTTGGCCATTGTGTG
AAAAAAAACATAACGGACTAAAGC	TGTTGTAAGGGACCTC
AAAAAAAAACACCTTGACTAAAGC	TGTTGTAAGTTGTCTT
AAAAAAAAAGGGTTGCTAGCTGAG	TGTTGTTTCTATTGTC
AAAAAAAAGTGATGGCTTAGGCCT	TGTTTGTTCTTGCTAT
AAAAAAAATGAATTGACTCAGTAA	TTAAAGGCAATAATGG
AAAAAAAACGAGGTTACTCAGTAA	TTAAAGGCACAACCTA
AAAAAAAAAACCTAAGAGGAACCT	TTAACCAAGAATCTCA
AAAAAAAAGAAGTGAGAATCGAGC	TTAAGCCAGTGATTCA
AAAAAAAATGCGCTTGAATCGAGC	TTAAGCCAGTTTAACG
AAAAAAAACTCGCACACCGTAATA	TTAAGGACAAGTGTCC
AAAAAAAATGCCAGAACCGTAATA	TTAAGGACAGCAACCT
AAAAAAAACCGGTTCACCGTAATA	TTAAGGACAGTAAGTA
AAAAAAAATTAAGGTACCGTAATA	TTAAGGACAGTAGGTG
AAAAAAAACTTAAGAACCGTAATA	TTAAGGACATAATTGC
AAAAAAAACTCTCACTGGCGATAA	TTAAGGTGTCGTTATC
AAAAAAAACCAGGGACTTAAGGAC	TTAAGTGTCCCTCTAA
AAAAAAAATAGCCCTGATCGATTT	TTAATCGAGTGAACCT
AAAAAAAAGCTTTGGTGCGTAATC	TTACACCGTTTGAGGC
AAAAAAAACCTAACCGAATGACTA	TTACAGCAGGACCTGC
AAAAAAAATAGGTACGAATGACTA	TTACAGCAGGTAAGCA
AAAAAAAACGAGCTGGAATGACTA	TTACAGCAGTATTGCA
AAAAAAAAAGGTTCCTGATGACAG	TTACCGTGTTAAGTGT
AAAAAAAACTAACCGCTAGGATCG	TTACGTTTCTGTGCAG
AAAAAAAATTAAAGCACTTACTCG	TTAGACTCATAATCCG
AAAAAAAACGACTTGCTTGAAGTG	TTAGCAATCAAGTGTC
AAAAAAAAATTAAGGCTTGAAGTG	TTAGCAATCACCGGTA
AAAAAAAACGGAGCACTTGAAGTG	TTAGCAATCCTAGTAA
AAAAAAAACGTTATGTGGTGAGCG	TTAGCAGGTAATCGTG
AAAAAAAATGCTTAGTGGTGAGCG	TTAGCAGGTCAACAAT
AAAAAAAACACAGGATGGTGAGCG	TTAGCAGGTTATGTGG
AAAAAAAATTAGCCATGCTTCCTG	TTAGCCTGTGCATCGG
AAAAAAAAGTTGAAGTGCTTCCTG	TTAGCCTGTTACCGGG
AAAAAAAAAAGTAACCTTTATGAC	TTAGCGGTCTTGATGA
AAAAAAAACACATAAACATTCAGG	TTAGCTGCATGAATCT
AAAAAAAAGTGGTGCACGTATTGG	TTAGGAACATAAACCT
AAAAAAAAGGCATTTCTAGCTCGC	TTAGGCGTCATTAGTG
AAAAAAAAACAATAGCTAGCTCGC	TTAGGCGTCTAAATCG
AAAAAAAAGTCAATAGATTTGAGG	TTAGGCTAGCGCCTTT
AAAAAAAAACGATTAGATTTGAGG	TTAGGCTAGTGAGCAA
AAAAAAAAGTGAACCGATAACGTG	TTAGTCAAGCAAACCT
AAAAAAAACGATTGAGATAACGTG	TTAGTCAAGGTGAAAT
AAAAAAAAAATTGCGACATTGACG	TTATAGCCAATGAGGT
AAAAAAAACCTAAGGACATTGACG	TTATAGCCATTGTCCT
AAAAAAAATGACTTACTTTCTTGC	TTATCCGTCGAGGTGG
AAAAAAAAGGCTTAGGATGCATGA	TTATCCTAGACACTTA
AAAAAAAAGTGAACCGATGCATGA	TTATCCTAGCAAACCT
AAAAAAAATGGCATGACTATGGAT	TTATGACCATAAGTCT
AAAAAAAATTCCGGCACTATGGAT	TTATGACCATATTGAC
AAAAAAAACATGGTGACCGCACCT	TTATGCGCATACCCGG
AAAAAAAATACGCACCTCCGTCAA	TTATTGCTCACTCAAA
AAAAAAAACAGGGACCTCCGTCAA	TTATTGCTCCCGAACA
AAAAAAAATGCAGCTCTCCGTCAA	TTATTGCTCCCTCAGT
AAAAAAAACAAGTCCCTCCGTCAA	TTATTGCTCGTTACTT
AAAAAAAACCACTAATGCGCCACA	TTCAACCGTATTGTCC
AAAAAAAACAGATTCTGCGCCACA	TTCAACCGTCTTGCAT
AAAAAAAATACTTGCACTTGTTGC	TTCAGCACATAATGTC
AAAAAAAATCGATTTGACATTACT	TTCAGGTAGCGAAGTA
AAAAAAAATTTAGCTGACATTACT	TTCAGGTAGTAATCCA
AAAAAAAAGGATTGGCTTTATCCC	TTCAGTTTCAGTGAAG
AAAAAAAATTGGACCCTTTATCCC	TTCAGTTTCCGGTTAG
AAAAAAAATTTGGAAACCTCTAAC	TTCATCCCACCAAAGG
AAAAAAAAACCTGCTACCTCTAAC	TTCATCCCATTGCGAC
AAAAAAAAAGTTACAGACATAAGC	TTCCCACAGCTAGAAG
AAAAAAAAGATTGCGGACATAAGC	TTCCCACAGTGAACAG
AAAAAAAAAGTAACCACAGGAAAT	TTCCCGCCACTTGTTC
AAAAAAAACAATTGGGACCTAGCT	TTCCTCAAGCATGCAT
AAAAAAAAAGCTAGCGACCTAGCT	TTCCTCAAGGCGCTAC
AAAAAAAACAGTAAGCTGTTAACC	TTCCTTCTCACAGACT
AAAAAAAACCAGAAACTGTTAACC	TTCCTTCTCCTAAGTA
AAAAAAAATTACCCAACCTTACTG	TTCGCAACATTATGAC
AAAAAAAAGGTTACAACCGGCAAT	TTCGGTACAATACTGT
AAAAAAAAGAGGAACACCGGCAAT	TTCGGTACACCACAAC
AAAAAAAAATCTGGAACCGGCAAT	TTCGGTACAGGTTTGC
AAAAAAAAATGCGCTTGGCTATTA	TTCGTTAGTTCCAGGG
AAAAAAAATCACGATTGGCTATTA	TTCGTTAGTTTACGTC
AAAAAAAACATGAAATGTGCTGGC	TTCTTAGGTCGTAAAT
AAAAAAAATCCTCAAACCTAGCTT	TTGACATCATCAGTAT
AAAAAAAAACATAACGACACTAAG	TTGACGTAGAACCTGT
AAAAAAAACCATCACGATTCCTGG	TTGACTAAGCTACTGG
AAAAAAAACAAATGCGATTCCTGG	TTGACTAAGCTGCACA
AAAAAAAACCCGAAGGATTCCTGG	TTGACTAAGGCATTGT
AAAAAAAATCGACCTGATCACATT	TTGCAACAGGATCCGC
AAAAAAAACTGGACGGATCACATT	TTGCAACAGGCTAATC
AAAAAAAACATTTGTGATCACATT	TTGCAACAGTCACCAG
AAAAAAAAACCCTCCTGGTTGACC	TTGCAAGGTGGAAACG
AAAAAAAAAGCCTCTACCTCCCTT	TTGCAATCAGGATTAA
AAAAAAAAAACCACAACCAGTTTC	TTGCACACAAGGTCGA
AAAAAAAAGCAATTGACCCTGTTA	TTGCAGCCATTGACAT
AAAAAAAACCTGCAACTAGTAGCG	TTGCATTTCATTGACA
AAAAAAAATAAGGTGCTAGTAGCG	TTGCATTTCCTCACAC
AAAAAAAATTCGCGACTAGTGTGG	TTGCGAGTCTGTAATG
AAAAAAAACTAGATTCTGGCAATG	TTGCGTCTCCGGGACT
AAAAAAAATACCCTTCTGGCAATG	TTGCGTCTCCTCCTAA
AAAAAAAACTTCGTAACAGGCATT	TTGCTCTCACAACAAA
AAAAAAAAGAGCCTGACAGGCATT	TTGCTCTCAGGACACA
AAAAAAAAGGACTTAACAGGCATT	TTGCTCTCATCCCTCA
AAAAAAAAGGATTAGTGGGCCATT	TTGCTTAGTATTCGTC
AAAAAAAAGAAGTCATGGGCCATT	TTGCTTAGTCAAACTG
AAAAAAAACTTCATTTGGGCCATT	TTGCTTAGTCCCGGAA
AAAAAAAAGACCAGGTGGGCCATT	TTGCTTAGTTTCGCGC
AAAAAAAATAACTTCGAGCTTGAG	TTGCTTTAGCCTGGTA
AAAAAAAAGATAATCGAGCTTGAG	TTGCTTTAGTCACTAA
AAAAAAAAACGGCTCCTTTGTTGA	TTGGATATCAAAGGCA
AAAAAAAATTTGCTCCTTTGTTGA	TTGGATATCATAGCCG
AAAAAAAACGTAGTAGAAGTGAGA	TTGGATCAGGATAAAC
AAAAAAAAAGCACTAACTAGCTTC	TTGGATTCACCGTTCC
AAAAAAAATTCACCAACTAGCTTC	TTGGATTCATTCCTCG
AAAAAAAAAGTCACAACTTTACGC	TTGGCTACAAATATCC
AAAAAAAAGGATCCAGACCAGGGT	TTGGCTGAGTGAACGA
AAAAAAAATCCACCTTGAAACTGG	TTGGCTTGTAAGGTTT
AAAAAAAACGCTAATTGAAACTGG	TTGGCTTGTCCTTCTC
AAAAAAAAAATCCCTGAAGGTGTC	TTGGGCCAGGCTCATG
AAAAAAAACAGTTAGGAAGGTGTC	TTGGGCCAGTAAGTGG
AAAAAAAAAATTAGCGAAGGTGTC	TTGGGCCAGTGTTGCG
AAAAAAAACAATCCATGCGCCTTT	TTGGGCGGTCCAAATG
AAAAAAAACATAACCTGCGCCTTT	TTGGGCGGTTGTAACG
AAAAAAAAGAGGTGGGACTCACAC	TTGGGTTAGAGGGACT
AAAAAAAACTAGGCGGACTCACAC	TTGGGTTAGGGACTAA
AAAAAAAAGGATTGCGACTCACAC	TTGGGTTAGGTGTTAC
AAAAAAAACAGCATTTGGTCCGTA	TTGGTGAGTGAACAAA
AAAAAAAAGGTCATGGAGGCTAGT	TTGTCAAAGGACTAAG
AAAAAAAAGTAACTAGAGGCTAGT	TTGTCAAAGTAGGATG
AAAAAAAAGTTGACGGAGGCTAGT	TTGTCAAAGTTCCTGC
AAAAAAAATTGACCGCTCAATACT	TTGTCCATCATGGTGT
AAAAAAAATGCATCGCTCAATACT	TTGTCCATCGAGGAAC
AAAAAAAATTAAGTCCTCAATACT	TTGTCCATCGGTTACG
AAAAAAAAGATTAGTGAGCGCTAA	TTGTCCCAGCTTATGA
AAAAAAAAGCAGTAATGTGCGATT	TTGTCCGGTATTGGAT
AAAAAAAAATGCTATTGTGCGATT	TTGTCCGGTTAGTTGG
AAAAAAAAAAGAACCTGAGCAAAC	TTGTGAGGTAATGGAA
AAAAAAAAAGAATCGTGAGCAAAC	TTGTGAGGTACCGGAT
AAAAAAAAAGATTAGCTGGTTTAC	TTGTGCCTCATGCGTG
AAAAAAAACTCTATGACATGTTTC	TTGTGTGCACACCAAC
AAAAAAAAGTGGCCAACCTTGAAA	TTGTTCCCAAGTTATC
AAAAAAAAATGAGAAACCTTGAAA	TTGTTCCCACAATACT
AAAAAAAACAGCGATACCTTGAAA	TTGTTCCCACCTAAGC
AAAAAAAACCACTATACCTTGAAA	TTGTTCCCAGTCTAGC
AAAAAAAATCATCACACCTTGAAA	TTGTTCCCATAGCTTG
AAAAAAAAAGGTTACACCTTGAAA	TTGTTCCCATCAATCG
AAAAAAAATTATTCCTGCTTCACC	TTGTTGCGTGCTTTAC
AAAAAAAACCTGCTCCTTAACGAG	TTGTTGTTCTTGACCC
AAAAAAAAATTGGGATGCTTGCTC	TTGTTTGGTTGCGGAT
AAAAAAAAGCTATACCTTAATGTC	TTTAACCTCCTGTTCA
AAAAAAAATGCTAGCCTTAATGTC	TTTAACCTCGCACAAT
AAAAAAAAACCAAATGATGGCTAA	TTTAACGAGCTATTAG
AAAAAAAATCTCAATGATGGCTAA	TTTAACGAGGTCATTA
AAAAAAAAGTAGGTTACCCTCAAT	TTTAAGCCAGGCGAGT
AAAAAAAATGTGGACACCCTCAAT	TTTAAGCCATTGGGAG
AAAAAAAACAGTAAGCTTGAGGTA	TTTAAGGTCACAGACT
AAAAAAAACAGGAATCTTGAGGTA	TTTAAGGTCTCTAGCC
AAAAAAAAGTGATGATGTGAGTAA	TTTACGCGTAACCACA
AAAAAAAATTTCCGGGACTTATTG	TTTAGCAAGCCAGTAT
AAAAAAAAGGGCTATGACTTATTG	TTTAGCAAGGTGAAGC
AAAAAAAATTATAGCCTCATCAGC	TTTAGCTTCGTTATCT
AAAAAAAACAGGAATCTCATCAGC	TTTAGCTTCTCTAGCC
AAAAAAAACGTTATTGACAGCCAG	TTTATGGAGGCTTAAC
AAAAAAAACGAGCTGGACAGCCAG	TTTATGGAGTATTGCA
AAAAAAAATCACCATACTTAGGCG	TTTCACCCAAGACTCC
AAAAAAAACTCTATGACTTAGGCG	TTTCACCCACACCAAC
AAAAAAAAGCACGGTACTTAGGCG	TTTCACCCACGAATTT
AAAAAAAACTCAAGGACTTAGGCG	TTTCACCCATTAGGTT
AAAAAAAATGTAAGTACTTAGGCG	TTTCACCCATTATGGT
AAAAAAAAAGTGAATCTTGTGTTA	TTTCAGTTCAAGCCTG
AAAAAAAAACATTGCCTTGTGTTA	TTTCAGTTCAGAAACG
AAAAAAAACATTCCTCTTGTGTTA	TTTCAGTTCATGAGCT
AAAAAAAAGCGATAGCTTGTGTTA	TTTCAGTTCTAATTGG
AAAAAAAACAGCTAAGAACTTGTC	TTTCATCAGGCCAATT
AAAAAAAAAGCCATAACTCAACAA	TTTCCACCAAGTCGCT
AAAAAAAAGAACCGCACTCAACAA	TTTCCACCAGGAACAT
AAAAAAAAATCCAAGACTCAACAA	TTTCCACCATACTCCT
AAAAAAAACCGGTACTGTTTGGAC	TTTCCGGGTAAGTCGC
AAAAAAAAACAGCCTTGTTTGGAC	TTTCCGGGTAGGATCC
AAAAAAAAAGCCTGTTGTTTGGAC	TTTCCGGGTTAGTACG
AAAAAAAACCTAAAGGAACAATGT	TTTCCTGAGGTCAAAG
AAAAAAAAAGGTTACACTTAGTAG	TTTCGTCCATCAATCG
AAAAAAAAAGAACCTACGATTGCA	TTTCTCACAATAATCC
AAAAAAAACCCAATTACGATTGCA	TTTCTCACACCATATG
AAAAAAAAGTGGTTAACGATTGCA	TTTCTCACACTCAACA
AAAAAAAAGCGGTCAACTAAAGGG	TTTCTTGCAACCGCCA
AAAAAAAAGCGGTTGACTAAAGGG	TTTCTTGCAAGGAATC
AAAAAAAAGACTTGCTGCTCACAA	TTTGACCGTTTACCGT
AAAAAAAAAGCTTGCTGCTCACAA	TTTGACCGTTTAGCTC
AAAAAAAACGACTTGCTACCTAGT	TTTGACTTCAAGTGTC
AAAAAAAATTACAACCTACCTAGT	TTTGACTTCCTGGTCT
AAAAAAAACTTATGACTACCTAGT	TTTGACTTCGTGCTTC
AAAAAAAACAGTAATACTAGCTGG	TTTGAGTCAAATGCCC
AAAAAAAAAACCACAACTAGCTGG	TTTGAGTCAAGGTCGA
AAAAAAAAGCCAAATACTAGCTGG	TTTGAGTCACTTCATC
AAAAAAAAGTGGATTACTAGCTGG	TTTGAGTCAGCAACAG
AAAAAAAATAGCCACCTATCCGTA	TTTGCATTCGATTTGA
AAAAAAAAATCCAAGACCTCACAT	TTTGCGACATACTCCT
AAAAAAAAGTTAGGCGAGCTATCT	TTTGGTAAGCAGGTTT
AAAAAAAAGCCACTTACAAACAAG	TTTGGTGCACCCTCAC
AAAAAAAAGCTAGTAACAAACAAG	TTTGGTGCACCTAATG
AAAAAAAATGCAACAGAATTGACA	TTTGTCTAGAGGCTAA
AAAAAAAAAACTGATGACACCTAC	TTTGTGAAGCATCCAG
AAAAAAAACGTGATGACACCAAAC	TTTGTGGCAATGAATG
AAAAAAAAAAACATGCTTGAGAAC	TTTGTGTTCCAATAGC
AAAAAAAACTCCCACCTTGAGAAC	TTTGTGTTCCCTGACT
AAAAAAAAGTGGTGACTTGAGAAC	TTTGTGTTCCGCCTCA
AAAAAAAATGCGTGTCTTGAGAAC	TTTGTGTTCCTGGTGA
AAAAAAAACATAGCTTGAAGTACG	TTTGTTGGTCTTACTA
AAAAAAAACAATGAATGAAGTACG	TTTGTTGGTGATGGCT
AAAAAAAACTACCGGTGAAGTACG	TTTGTTGGTGTTAAAC
