ATAC	RNA
AAAAAAAACTGTTACACCTAAATG	AAACATGCAACAGGTG
AAAAAAAAGTGCTGGACCTAAATG	AAACATGCACCCACCT
AAAAAAAAGCTAGTAACCTAAATG	AAACATGCACCTAATG
AAAAAAAATGACATAACCTAAATG	AAACATGCATTAAACC
AAAAAAAACATCGTTACGATAAAG	AAACCAACAACATAAG
AAAAAAAACCCAATTACGATAAAG	AAACCAACACCATATG
AAAAAAAAGTGCTGGACGATAAAG	AAACCAACACCCACCT
AAAAAAAAGGAATAAACGATAAAG	AAACCAACAGTTATCG
AAAAAAAAGATTACGACGATAAAG	AAACCAACATGTTGTG
AAAAAAAACTGCTGTGAATAGTCA	AAACCGAAGGGATGAC
AAAAAAAAAGTTTGAGAATAGTCA	AAACCGAAGTAACCAC
AAAAAAAAAGGGACCTGAGCTATT	AAACCGCGTAACGAGG
AAAAAAAACGGCTCATGAGCTATT	AAACCGCGTAATAGCT
AAAAAAAAAAGGGAGTGAGCTATT	AAACCGCGTAATGGCC
AAAAAAAAGGAGCAAACGGGTTAT	AAACGCGCACAGGATG
AAAAAAAACAGGTTCCTAGGCCTC	AAACGGATCACTTTAC
AAAAAAAAGATATAGCTAGGCCTC	AAACGGATCATTAGCA
AAAAAAAATTACAACCTAGGCCTC	AAACGGATCCTGGTCT
AAAAAAAAGCTTATTACTAAGCGC	AAACGTACATAAAGCA
AAAAAAAATCCTCCATGAGCCTGT	AAAGCAAGTTGTCCAT
AAAAAAAAAGAATGAACTAACCCT	AAAGCACCAGGCTGTT
AAAAAAAAGTTAGTTTGGAAACTG	AAAGCCCGTTGAGGTC
AAAAAAAATACAACCTGGAAACTG	AAAGCCCGTTTGTCTA
AAAAAAAACACGGATACTCCCTCT	AAAGCCGCAGGAATCG
AAAAAAAACTGAGCAACTCCCTCT	AAAGCCGCAGTAGCCT
AAAAAAAACCATTGTACTCCCTCT	AAAGCCGCATAAGGAC
AAAAAAAACACAATAACTCCCTCT	AAAGCCGCATCGTTCT
AAAAAAAAATTGGTGACTCCCTCT	AAAGCCGCATTGTTGG
AAAAAAAATCATTTCTGGACACAA	AAAGCGGGTCCTTTAA
AAAAAAAATCAAACCTGCTGAGGA	AAAGCTTGTAGCTGCG
AAAAAAAATGTTGGTTGGCTAATT	AAAGGACGTGCATTAG
AAAAAAAAATAAGCCACACCGTTC	AAAGGAGCACCTACGG
AAAAAAAACCGTTTAACACCGTTC	AAAGGAGCACTGACTA
AAAAAAAAGTTCACCACACCGTTC	AAAGGAGCAGCTTAAT
AAAAAAAAGATTTGGACCTAATCC	AAAGGCTCAATTAGCT
AAAAAAAATCCCATAACCTAATCC	AAAGGCTCAGAAATGC
AAAAAAAAGCAACATACCTAATCC	AAAGGCTCAGTGAACG
AAAAAAAATAAAGCTACCTAATCC	AAAGGCTCATAGCGGA
AAAAAAAATTCACTGACCTAATCC	AAAGGCTCATCCTGAA
AAAAAAAACGCTAAAGAACTAAAC	AAAGGTTAGACAACGA
AAAAAAAAGAGTTGCGAACTAAAC	AAAGGTTAGATGGAGC
AAAAAAAAAGAAACCTGTTGCATG	AAATCCGGTCATTAGG
AAAAAAAAACGCGTTTGTTGCATG	AAATCCGGTGAGAAAC
AAAAAAAAAGTAAGTCTAAGAATC	AAATGCCTCAATACGC
AAAAAAAAGTGAGCACTAAGAATC	AAATGCCTCATGTCAA
AAAAAAAAAAATACGCTAAGAATC	AAATGCCTCTAACTGA
AAAAAAAAAGCTGTAACTTACCTG	AAATGGCCACGTTACA
AAAAAAAAGCTACAAACTTACCTG	AAATGGCCAGGCTACT
AAAAAAAAGGTTACCTGCACACTA	AACAAAGGTAGCCATA
AAAAAAAAGAACTGATGCACACTA	AACAAAGGTGATGATT
AAAAAAAAAGGTTCCTGCACACTA	AACAAAGGTTAAGTGT
AAAAAAAACAATTGAACGTAGTTG	AACAAGCCAACAACAA
AAAAAAAAGGTTGTAACGTAGTTG	AACAAGCCAATCGCAC
AAAAAAAAAGCCGGTACGTAGTTG	AACAAGCCACAGACTC
AAAAAAAAAGTATTGGAAGGTGCT	AACAGATAGCGTGCAC
AAAAAAAACCACAAAGAAGGTGCT	AACAGATAGTTGGGCC
AAAAAAAACCGAAGCGAAGGTGCT	AACAGATAGTTTGGTA
AAAAAAAATCGTACCGAGTGTGAC	AACAGCAAGCCAAATC
AAAAAAAAATGTGCGGAGTGTGAC	AACAGCAAGCCTGTGA
AAAAAAAACTGGACGGAGTGTGAC	AACAGCAAGGCTAATC
AAAAAAAAGCATATAGAGTGTGAC	AACAGCAAGGTCCTGA
AAAAAAAAGGTAGCTGAGTGTGAC	AACAGCAAGTCTTGAA
AAAAAAAACAACCTGCTATGAGGC	AACAGGATCGCGACAC
AAAAAAAATTCGCGCACACTTGTT	AACATAGCAAACCTAT
AAAAAAAACAGTAATACACTTGTT	AACATAGCAAATGCCC
AAAAAAAAGCAATTGACACTTGTT	AACATAGCATTGACAT
AAAAAAAAACCGCCACTGCGCGTT	AACATCATCATGTGGT
AAAAAAAAATTGTGCCTGCGCGTT	AACATCATCCCAGTAG
AAAAAAAAAAACTAGCTGTAATAG	AACATTGTCGCATTAA
AAAAAAAACGAGTTAGAGGTTACG	AACCCGCAGCACGATT
AAAAAAAAGCCCAAAGAGGTTACG	AACCCGCAGCCGCAAC
AAAAAAAATCAGTAAACCAGTAGC	AACCGCTCAGCAAGAT
AAAAAAAAGCTTATTACCAGTAGC	AACCGCTCATAAAGCA
AAAAAAAAGCCAACCCTACTTAGC	AACCGGCTCCATAATG
AAAAAAAACCAGGGACTACTTAGC	AACCGGCTCCCTCTAA
AAAAAAAACTAGCCACTACTTAGC	AACCGGCTCCTGAATA
AAAAAAAAGAATTGACTACTTAGC	AACCGGCTCTCATCAT
AAAAAAAACTAACCGCTACTTAGC	AACCGGCTCTGTGCAG
AAAAAAAAAGAGCTGCTCATGCTG	AACCTAATCAAGTGAG
AAAAAAAAGTCTTGACTCATGCTG	AACCTAATCATGACCG
AAAAAAAAAAACTAGCTCATGCTG	AACCTAATCGCATTAA
AAAAAAAAGTGGCCAACCGCTAAG	AACCTCACAAGTTATC
AAAAAAAAGATTGCAACCGCTAAG	AACCTCACAATTAAGG
AAAAAAAATCAATGAACCGCTAAG	AACCTCACACAAGCCT
AAAAAAAAGATTACGACCGCTAAG	AACCTCACATGTTGTG
AAAAAAAACGTAAAGCTCATGATT	AACCTCCTCAATGTCA
AAAAAAAATACGCACCTCATGATT	AACCTCCTCACTCAAA
AAAAAAAAGCGACTCCTCATGATT	AACCTCCTCGCTATGG
AAAAAAAACGCGAGTGAGATTAAC	AACCTTAAGAAAGGAA
AAAAAAAAAAGTGAGGAGATTAAC	AACCTTAAGACAAGTG
AAAAAAAAGTGAACCGAGATTAAC	AACCTTAAGCAAACCT
AAAAAAAAAACCCTTGAGATTAAC	AACCTTAAGCGATAGA
AAAAAAAACTTCCTTGAGATTAAC	AACCTTAAGGCTATGT
AAAAAAAAGGCTAACGAGATTAAC	AACCTTAAGGTCCACA
AAAAAAAAGCATATAGAGATTAAC	AACCTTAAGGTCCTGA
AAAAAAAAAATCCGGGAGATTAAC	AACCTTAAGTTAGACC
AAAAAAAATAAGCACGAGATTAAC	AACCTTAAGTTAGTGC
AAAAAAAAACAAAGAACTTTGTGC	AACCTTGCATAATCGT
AAAAAAAAATGCTTTACTTTGTGC	AACCTTGCATCACTTC
AAAAAAAATTGGTTTGACACCTTG	AACGACAAGCCTAATA
AAAAAAAACCATCACGACACCTTG	AACGACAAGCTACTGG
AAAAAAAACGACCTTGACACCTTG	AACGACAAGTCAGGCC
AAAAAAAAGCTTATCGAAAGGCAA	AACGCCCAGGAGTCTT
AAAAAAAAACCAGGTGAAAGGCAA	AACGCCCAGTTGTCAA
AAAAAAAAATTGAGGTGGAAGGCC	AACGCTAGTGTGAGAG
AAAAAAAATGTTGTTGAACCTACT	AACGGTAAGACAACAG
AAAAAAAACTTTAACGAACCTACT	AACGGTAAGCTATATG
AAAAAAAACTCTATGACTGATGGC	AACTACTCACACCAAC
AAAAAAAATGATTAGACTGATGGC	AACTACTCAGCAAGTG
AAAAAAAACGATTAAACTGATGGC	AACTACTCATTGTCAG
AAAAAAAAGTCGATTCTCCTCGTC	AACTAGCTCATTTGTC
AAAAAAAACTACCGGTGACCGTTG	AACTAGTGTGTTAAAC
AAAAAAAATCCTAAGTGACCGTTG	AACTAGTGTTAACGGC
AAAAAAAAGCTGCAAGATTGAAGC	AACTCACAGGCTGTCA
AAAAAAAAGGGTTTGGATTGAAGC	AACTCACAGTGTTGTA
AAAAAAAAGCCACTTACCATACCT	AACTGTTCACCCTCAC
AAAAAAAATTAAGGTACCATACCT	AACTGTTCAGTAGGTG
AAAAAAAACTGACCGTGCCCGTTT	AAGAACAGTAAAGCGG
AAAAAAAACTTCATTTGCCCGTTT	AAGAACAGTCCCGGAA
AAAAAAAAAGCCTGTTGCCCGTTT	AAGAACAGTTAGTACG
AAAAAAAAAGCTTGCTGCCCGTTT	AAGAACAGTTTAGCTC
AAAAAAAATAGGTTGGACGGATTA	AAGAATCAGGGCCACT
AAAAAAAACCTAAAGGACGGATTA	AAGAATCAGGTCAAAG
AAAAAAAAGTGATGATGAAGCAAC	AAGACAAGTAACCACA
AAAAAAAAACAGCCTTGAAGCAAC	AAGACAAGTAGGATCC
AAAAAAAACGGTTTATGAAGCAAC	AAGACAAGTTACTTCA
AAAAAAAAACTTGAAGACACCGTT	AAGACATAGGTTTACA
AAAAAAAAGTAATGTGAATCCATC	AAGACCAAGGAGGACT
AAAAAAAAAATGAGGGAATCCATC	AAGACCAAGTAGCCAT
AAAAAAAATTTGTACGAATCCATC	AAGACCAAGTTGTCCC
AAAAAAAATTGCTTAGAACCAGGT	AAGCATGAGACAAAGT
AAAAAAAATCCTTAAGAACCAGGT	AAGCATGAGCACAGAA
AAAAAAAAGATCCAGGAACCAGGT	AAGCATGAGCCGCTTT
AAAAAAAAATGGGCGTGATTTGGT	AAGCCACGTAGGTGTC
AAAAAAAACTCCTACTGATTTGGT	AAGCCACGTTTGACCT
AAAAAAAACATGAGCACTAAAGCT	AAGCCTCCAACTGGGA
AAAAAAAATGCGTGAACTAAAGCT	AAGCCTCCACATTAAC
AAAAAAAAGATTACGACTAAAGCT	AAGCCTCCATGTTGTG
AAAAAAAAAGTTGTCCTTCCTTCA	AAGCCTGTCAATTACG
AAAAAAAAATAGCCTCTTCCTTCA	AAGCCTGTCACGCGGT
AAAAAAAAAAAGGTTCTTCCTTCA	AAGCCTGTCGATCAGT
AAAAAAAAAGTCATCCTTCCTTCA	AAGCCTGTCGTGCTAG
AAAAAAAATCATGGAGAATTAGCA	AAGCCTTAGACCATAC
AAAAAAAAGTTAGTAGAATTAGCA	AAGCCTTAGAGGAGTC
AAAAAAAACTGGCTTGAATTAGCA	AAGCCTTAGATTGAGG
AAAAAAAAGGCATGACTTGCAACC	AAGCGAATCCAGGTTG
AAAAAAAATACCCTTCTTGCAACC	AAGCGAATCCTCCTAA
AAAAAAAACAGTTATCTTGCAACC	AAGCGAATCTAAGGAG
AAAAAAAATTGAAGGCTCCATCCC	AAGCGTTTCGCCTGTT
AAAAAAAAAAAGGACGATGTAACG	AAGCTAGAGCCTAACG
AAAAAAAATTAGGACGATGTAACG	AAGCTAGAGGGTTATC
AAAAAAAAGCATATAGATGTAACG	AAGCTAGAGGTCCTGA
AAAAAAAACTGCCAGTGTTGCACA	AAGCTATGTAACGGGA
AAAAAAAACGTCAATTGTTGCACA	AAGCTATGTAGCTAGC
AAAAAAAACAGATAATGTTGCACA	AAGCTATGTAGGTTAT
AAAAAAAATTGCGCGTGTTGCACA	AAGCTATGTCAATACG
AAAAAAAATGGGCAATGTTGCACA	AAGCTATGTCATCATC
AAAAAAAACCTTTATTGTTGCACA	AAGCTATGTCATCCTG
AAAAAAAAAGCTTGCTGTTGCACA	AAGCTATGTTTAGCTC
AAAAAAAACCGGTAAACACTTACT	AAGCTCCCAAGCCACT
AAAAAAAACCGAAGTACACTTACT	AAGCTCCCATGGCCCA
AAAAAAAAAGTACTGACACTTACT	AAGCTCCCATTATCCC
AAAAAAAAACGGTTCTGTTTAGCG	AAGCTTGGTAGCTAAT
AAAAAAAACCTTATTTGTTTAGCG	AAGCTTGGTTGTTCAC
AAAAAAAAGGATTGATGTTTAGCG	AAGCTTGGTTTACTTG
AAAAAAAAGGCCGATACGTAATCG	AAGGATCCAATTAACC
AAAAAAAACTAGTAAACGTAATCG	AAGGATCCAGTAAAGC
AAAAAAAAACTGCAAACGTAATCG	AAGGATCCAGTTATGT
AAAAAAAAAGGTGCACTCTAAGGA	AAGGATGTCAGGTTTA
AAAAAAAACATAGCCCTCTAAGGA	AAGGATGTCATTGTCT
AAAAAAAATAGCAAGCTAACAGTA	AAGGCCCTCATTAGGC
AAAAAAAAGCTATGGGACATTGAG	AAGGTATAGTAGCTTA
AAAAAAAATATCAGGGATTCAGGA	AAGGTGCAGTTACCGG
AAAAAAAATGGTCAAGATTCAGGA	AAGGTGCAGTTTGCGG
AAAAAAAATGCGTGAACAACAAAG	AAGTAGCCACATTAAC
AAAAAAAACAAGGCTACAACAAAG	AAGTAGCCAGCATGGA
AAAAAAAATGCAAGACTGACTTTG	AAGTCTATCAACCAAC
AAAAAAAACAATGAGCTGACTTTG	AAGTCTATCCGCTAGA
AAAAAAAAGCAAATACTGACTTTG	AAGTCTATCTCGACCT
AAAAAAAATGAGGCATGGTTAGAG	AAGTGAAGTGATCATG
AAAAAAAAGGTTAATGATTTGCGC	AAGTGCAAGAACCTAC
AAAAAAAATCACCTGGATTTGCGC	AAGTGCAAGCTATTGA
AAAAAAAAAGGCTGTGATTTGCGC	AAGTGCAAGGCTAGAA
AAAAAAAAAGGGACCTGAGGCGCA	AAGTGTTGTAACGAGG
AAAAAAAAGCACCTATGAGGCGCA	AAGTGTTGTGTCCTGC
AAAAAAAAACGTATTTGTGAGCGA	AAGTTACGTACCGTTT
AAAAAAAATAGCTCATGTGAGCGA	AAGTTACGTAGCCTCC
AAAAAAAAGTTGCTGTGTGAGCGA	AAGTTACGTATACTGG
AAAAAAAACTTCGCTTGTGAGCGA	AAGTTACGTTAGGATT
AAAAAAAAAGGAGCAACTCACAGG	AAGTTAGCAAAGCGCA
AAAAAAAAGGAAGCAACTCACAGG	AAGTTAGCACTAAGTT
AAAAAAAACGCTAAGACTCACAGG	AAGTTAGCAGAATGAC
AAAAAAAAGTCCGGAACTCACAGG	AAGTTAGCATGGCCTG
AAAAAAAAGATAATGCTCCACCCT	AAGTTTGTCACAGGAA
AAAAAAAAGTGTTTGCTCCACCCT	AAGTTTGTCACCAATA
AAAAAAAAAGCTTACCTCCACCCT	AAGTTTGTCCTTGTTG
AAAAAAAATCCCACCCTCCACCCT	AAGTTTGTCTGGCAAT
AAAAAAAAAATTAGGCTCCACCCT	AAGTTTGTCTTGGATA
AAAAAAAACCAAGGGCTCCACCCT	AAGTTTGTCTTTGACT
AAAAAAAAAAACGGTTGCGTGCGT	AATAACCGTGGTTAGC
AAAAAAAACTGACATTGCGTGCGT	AATAACCGTTGGATAT
AAAAAAAACTCGAGCTGGCCATCA	AATACCGGTAACTACG
AAAAAAAATCCAGATTGGCCATCA	AATACCGGTTAAGCCA
AAAAAAAACGGACAATGGCCATCA	AATACCGGTTAAGGTT
AAAAAAAAGATTGAGTGTAATGGA	AATAGAGGTACAATGT
AAAAAAAAAGTCATTTGTAATGGA	AATAGAGGTATGTGGC
AAAAAAAAGCTACTCACCGCCTAC	AATATCCCACTGACCG
AAAAAAAACATAACGGAGACTCAG	AATCAGGAGGGACCTC
AAAAAAAAAAGAACAACTTAAGGT	AATCATCCAAACATAG
AAAAAAAAGGGTGAAACTTAAGGT	AATCATCCAATGCGCT
AAAAAAAATAGGTTTCTAGGCGAT	AATCATGTCGCTCACT
AAAAAAAAGGGAGTAACCTGATTC	AATCCATCAGCATGAG
AAAAAAAAGCTTATTACCTGATTC	AATCCATCATAAAGCA
AAAAAAAATTTGTGCACCTGATTC	AATCCATCATAGGCGA
AAAAAAAAATGGGCGTGTTAAGCC	AATCCCTGTAGGTGTC
AAAAAAAATATTGCGTGTTAAGCC	AATCCCTGTCACAGCG
AAAAAAAAGTTGACCTGTTAAGCC	AATCCCTGTTGCACGG
AAAAAAAATACAACCTGTTAAGCC	AATCCCTGTTTGTCTA
AAAAAAAAAATAGCTGATTCGCCA	AATCCGTAGCGATACT
AAAAAAAAGCCTATTGATTCGCCA	AATCCGTAGCGCAATT
AAAAAAAAACGGTGTGATTCGCCA	AATCCGTAGCTCGCTT
AAAAAAAAAGTCAATGACTAGGCG	AATCCTAAGCGCTAAT
AAAAAAAATGGGTTAGACTAGGCG	AATCCTAAGCTATGAC
AAAAAAAAAAAGCTTGACTAGGCG	AATCCTAAGGTACCGC
AAAAAAAACCGTTTAACAGCTATG	AATCGCCCACTGACTA
AAAAAAAATAAATGCACAGCTATG	AATCGCCCAGGCCATT
AAAAAAAATCAGTTTGACCCGGAA	AATCTCAAGTTAGGCT
AAAAAAAAAACCCTTGATTACGTT	AATCTTGAGCGATAGA
AAAAAAAAGTGGGAGGATTACGTT	AATCTTGAGCGGATAA
AAAAAAAAGCACTAGGATTACGTT	AATCTTGAGCTAATTG
AAAAAAAAGTTTCCAGATTACGTT	AATCTTGAGCTGGCTA
AAAAAAAATAGAAACTGAACCAAG	AATGAAGGTCGACTAA
AAAAAAAAGAACTGATGAACCAAG	AATGAAGGTGATGATT
AAAAAAAAAACTTGTTGAACCAAG	AATGAAGGTGCTCCGT
AAAAAAAATGGTGTGACACTAAGC	AATGCAACACAAAGGT
AAAAAAAATCAGTAAACACTAAGC	AATGCAACAGCAAGAT
AAAAAAAAGCAACATACACTAAGC	AATGCAACAGTGAACG
AAAAAAAAGGTTAACACACTAAGC	AATGCAACATTATGCG
AAAAAAAACGCATTATGCTAGCTA	AATGCATGTGGATTAT
AAAAAAAATCTGTGATGCTAGCTA	AATGCATGTTGACTTC
AAAAAAAAGATCATGACGGGCACT	AATGGCGCAAAGCTCC
AAAAAAAAAACGGACCTGCAACAG	AATGTCATCCTAGTTT
AAAAAAAATTATAGCCTGCAACAG	AATGTCATCGTTATCT
AAAAAAAACTAGTAGGACTAGGTA	AATGTCCAGCCGGTAC
AAAAAAAACTGATTTGACTAGGTA	AATGTCCAGCTTTGTT
AAAAAAAAGTCACAGGACTAGGTA	AATGTCCAGGACGTAA
AAAAAAAATGTGATGGACTAGGTA	AATGTCCAGGCAATAG
AAAAAAAATTTACGCACTAACCGG	AATTACCCAAGGTGCA
AAAAAAAAAATCGTGACTAACCGG	AATTACCCAGTTTCTC
AAAAAAAACTGAGTGACTAACCGG	AATTACCCATCCATCT
AAAAAAAACCGATTATGCAAGCTT	AATTAGCGTACCAGGT
AAAAAAAATGTTGCATGCAAGCTT	AATTAGCGTCAAAGGG
AAAAAAAATGTTGGTTGCAAGCTT	AATTAGCGTGCATTAG
AAAAAAAAAAACGGTTGCAAGCTT	AATTAGCGTGGTTAGC
AAAAAAAATAATCCGTGCAAGCTT	AATTAGCGTTAACAGT
AAAAAAAAGACTTGCTGCAAGCTT	AATTAGCGTTTACCGT
AAAAAAAACACCATATGCAAGCTT	AATTAGCGTTTATTCG
AAAAAAAATCAGTAAACATTGCCC	AATTAGGCAGCAAGAT
AAAAAAAAGTTCACCACATTGCCC	AATTAGGCAGCTTAAT
AAAAAAAATCATCACACATTGCCC	AATTAGGCATAGCTTG
AAAAAAAAGCTGGTGACATTGCCC	AATTAGGCATGCTATG
AAAAAAAAGCAATTGACATTGCCC	AATTAGGCATTGACAT
AAAAAAAATGTGGACACATTGCCC	AATTAGGCATTGGGAG
AAAAAAAACATAAGTACGGTAACT	AATTCGTCAAATTCGT
AAAAAAAAGCGGTTGACGGTAACT	AATTCGTCAAGGAATC
AAAAAAAACAGTGTGACGGTAACT	AATTCGTCACGAACAG
AAAAAAAAGAGAGCAACGGTAACT	AATTCGTCAGGACCTT
AAAAAAAAGAAGTCATGCGGTAAG	AATTGACGTCAAACTG
AAAAAAAACCGCTAGTGCGGTAAG	AATTGACGTTAGTGAT
AAAAAAAACAATTGGGACTGATCC	AATTGCCAGCATGCAT
AAAAAAAAGATCCAGGACTGATCC	AATTGCCAGCCGCTTT
AAAAAAAATGACAACGACTGATCC	AATTGCCAGTACCGCA
AAAAAAAATAGCTGAGACTGATCC	AATTGCCAGTCCTTCA
AAAAAAAAGAACCGCACATACCTT	AATTGCTCAGGAACAT
AAAAAAAAAACCTTTACATACCTT	AATTGCTCATAGACCC
AAAAAAAAGTTCAAGACCAAACTA	AATTGGACACCGGTAT
AAAAAAAAGCTCGTTACCAAACTA	AATTGGACACCTATAG
AAAAAAAAGAAACTCACCAAACTA	AATTGGACACCTCAGG
AAAAAAAACTTACTGACCAAACTA	AATTGGACAGCACGTT
AAAAAAAACCGGATAACCAAACTA	AATTGGACATGAATAG
AAAAAAAAACCCGCTGATCATGTT	AATTGGGAGCAAGGTA
AAAAAAAAGTTGCAGGATCATGTT	AATTGGGAGGCGAATA
AAAAAAAACCAGGGACTCCTGAGT	AATTGTGTCCCTCTAA
AAAAAAAAAGGTGCACTCCTTAAA	AATTTCCTCAGGTTTA
AAAAAAAAGCGTGTCCTCCTTAAA	AATTTCCTCGTGCCTT
AAAAAAAATTCGTAACTCCTTAAA	AATTTCCTCTATGACA
AAAAAAAAAGGTTAACTCCTTAAA	AATTTCCTCTGTAAGC
AAAAAAAAGTGGTTAACCTTTACG	AATTTGCCACTCAACA
AAAAAAAAATGGTCAACCTTTACG	AATTTGCCAGTCTATG
AAAAAAAAGAAAGGCACCTTTACG	AATTTGCCATCCAGGT
AAAAAAAAAGTCTTGCTGCTACTA	AATTTGGTCAAGCTAC
AAAAAAAAGGTTGTTCTGCTACTA	AATTTGGTCCAACTGG
AAAAAAAATCCCACCCTGCTACTA	AATTTGGTCTGGCAAT
AAAAAAAACATAGCTTGGTGCATC	ACAAACTGTCTTACTA
AAAAAAAAATTGAGGTGGTGCATC	ACAAACTGTGTGAGAG
AAAAAAAAAAGCCTAACTGACATA	ACAACAACATATAACC
AAAAAAAAGGTCATTCTGCAACCC	ACAACACTCGCTAGAT
AAAAAAAAGAAGCCACTGCAACCC	ACAACACTCGGCTATG
AAAAAAAAACTCATGCTGCAACCC	ACAACACTCGTTTCTG
AAAAAAAAGACCTGCCTGCAACCC	ACAACACTCTAGCGAT
AAAAAAAACCAGGTGGATGCTTAT	ACAACAGAGACTATTG
AAAAAAAATGCAGGATGATTCATG	ACACAATGTTTCCTCC
AAAAAAAATTGTTGGTGTAACGAA	ACACCTTGTAGGTTTG
AAAAAAAAGGTTCACTGTAACGAA	ACACCTTGTCTATCGT
AAAAAAAAGTTACCCACTAGGTAT	ACACGGACACAGAAAC
AAAAAAAACACCAACCTAATGTGA	ACACTAATCAATGTGC
AAAAAAAAACGTATTTGATGAAGC	ACACTAGGTACCGTTT
AAAAAAAAACTGAATGATTATTCG	ACACTTAAGCTTCCCG
AAAAAAAAGATGGCTGATTATTCG	ACACTTAAGGACACTT
AAAAAAAAAGAGGCGGATTATTCG	ACACTTAAGGCCTAAT
AAAAAAAAGTAACTAGATTATTCG	ACACTTAAGTAGGATG
AAAAAAAAAACGCTAACCTCACTA	ACACTTGCAAGTAAGC
AAAAAAAAATTCATCACCTCACTA	ACACTTGCACGCAACT
AAAAAAAACTTTAGGTGTTGGCCG	ACAGCCGGTAAGCTTG
AAAAAAAAAAACATGCTAAGGTGC	ACAGCGCTCCAATAGC
AAAAAAAATGAAAGCCTTCACTTC	ACAGGAATCATAACCA
AAAAAAAAGTGATGGCTTCACTTC	ACAGGAATCTTGCTAT
AAAAAAAAGCTCGTTACCAGCACA	ACAGGATCACCTATAG
AAAAAAAAGAGAGCAACCAGCACA	ACAGGATCAGGACCTT
AAAAAAAAAACCTTTACCAGCACA	ACAGGATCATAGACCC
AAAAAAAACCACTAATGGATTAGG	ACAGGCTGTATTGTCC
AAAAAAAACGCTAAAGATTAAGGC	ACAGGTAAGACAACGA
AAAAAAAAGCTAAATGATTAAGGC	ACAGGTAAGATAACCC
AAAAAAAATATTGCGTGACCTGGT	ACAGTATGTCACAGCG
AAAAAAAAGGTTCACTGACCTGGT	ACAGTATGTCTATCGT
AAAAAAAACAGATTCTGACCTGGT	ACAGTATGTCTTGCAT
AAAAAAAATTATTCCTGACCTGGT	ACAGTATGTGCTTTAC
AAAAAAAACTGACATTGACCTGGT	ACAGTATGTTGGATAT
AAAAAAAACAAGGGTTGACCTGGT	ACAGTATGTTTGTGGA
AAAAAAAAAACCTGTCTTCATCAA	ACATAGCTCCCTCATA
AAAAAAAATACATACCTTCATCAA	ACATAGCTCGAGCTAT
AAAAAAAACCGTTAGCTGTTTACG	ACATCAATCACAAGCT
AAAAAAAAGTCAATCCTGTTTACG	ACATCAATCGCTATAA
AAAAAAAATGCTGTTACCCGGTAA	ACATCATCAAGGATTA
AAAAAAAATTTACGCACCCGGTAA	ACATCATCAAGGTGCA
AAAAAAAAGGGTGAAACCCGGTAA	ACATCATCAATGCGCT
AAAAAAAAGGAGCAAACCCGGTAA	ACATCATCACAGGATG
AAAAAAAATGGGAGGACCCGGTAA	ACATCATCATAACGGG
AAAAAAAACAAGGGCCTAGGTACG	ACATTAGTCAGGCCTA
AAAAAAAATCTTGCTCTAGGTACG	ACATTAGTCAGTTCCC
AAAAAAAAAACCTGTCTAGGTACG	ACATTAGTCCCTCATA
AAAAAAAACAAGTCCCTAGGTACG	ACATTAGTCGTTACTT
AAAAAAAAAAGTCGCGAGCAGGTT	ACATTGCAGCAGGTGG
AAAAAAAAGCATAATGAGCAGGTT	ACATTGCAGGATCACT
AAAAAAAAGCTGCAAGAGCAGGTT	ACATTGCAGGCTGTCA
AAAAAAAAGTGGACACTAACACCT	ACCAAACTCACTTCAT
AAAAAAAAGCAAGTGCTAACACCT	ACCAAACTCGTTTCGC
AAAAAAAACTCGAGCTGTGGAGCA	ACCAAGCGTAACTACG
AAAAAAAATCCAGCACTACTCCCT	ACCAAGTTCCTAACGG
AAAAAAAACCAGAAACTACTCCCT	ACCAAGTTCCTAAGTA
AAAAAAAATCCAATACTACTCCCT	ACCAAGTTCTAATCAG
AAAAAAAACCAGGTTCTTAGTGCC	ACCAATATCCTCGATC
AAAAAAAAGGTTATCCTTAGTGCC	ACCAATATCGTTATAG
AAAAAAAATTTACGCACTAGGATT	ACCACACCAAGGTGCA
AAAAAAAAAGCTGTAACTAGGATT	ACCACACCACGTTACA
AAAAAAAACTGGCTTGAGGTAACC	ACCACATAGATTGAGG
AAAAAAAACATGAGCACAGCACGC	ACCAGCTCAACTGGGA
AAAAAAAAGGTTGTAACAGCACGC	ACCAGCTCAATCGCAC
AAAAAAAATATAGTGACAGCACGC	ACCAGCTCAGCTCAAC
AAAAAAAATTGCATCACATTGCGA	ACCAGGACAAGTGTTT
AAAAAAAATGCTTCAACATTGCGA	ACCAGGACAATAGCCC
AAAAAAAAAGCGTGCACATTGCGA	ACCAGGACAGAAACGT
AAAAAAAATGTAATGACATTGCGA	ACCAGGACATTAAAGG
AAAAAAAATGTGGACACATTGCGA	ACCAGGACATTGGGAG
AAAAAAAAAGGGTTGCTCTTGACG	ACCAGGCTCTATTGTC
AAAAAAAACCGCTATGAGGATGTC	ACCAGGGAGTTGCGTG
AAAAAAAATATATCGCTTTAGTAC	ACCATAATCAGTATTG
AAAAAAAATGGGTTAGATGACATG	ACCATTAAGCTATGAC
AAAAAAAACTAAAGCGATGACATG	ACCATTAAGTGTGATC
AAAAAAAATGTGCGGGATGACATG	ACCATTAAGTTTCCGC
AAAAAAAACATCCGTGATGACATG	ACCATTAAGTTTCCTG
AAAAAAAATGGTCAAGATGACATG	ACCATTAAGTTTGCGG
AAAAAAAAGCGATTAACTAACCAA	ACCCAACCAGAACCGA
AAAAAAAACTCAGGCTGTTGCGGC	ACCCAGGGTAATCCCT
AAAAAAAATAGCGGATGTTGCGGC	ACCCAGGGTCAAGTGC
AAAAAAAAGTTACCGTGTTGCGGC	ACCCAGGGTCCTAATC
AAAAAAAACATAGCTTGGGACAAT	ACCCGCTGTCTTACTA
AAAAAAAACACAGGATGGGACAAT	ACCCGCTGTTATGTGG
AAAAAAAAATTAGTGGAATAATGC	ACCCGGTAGGACCTTG
AAAAAAAAGGCGAGAGATTTGGAG	ACCCGTAAGGTCGATT
AAAAAAAACGCTTGTGATTTGGAG	ACCCGTAAGTAACGGA
AAAAAAAAGTAGCTAACTGAATGT	ACCCTCCCAAGGTAAC
AAAAAAAAAGAGCTGCTAACCAAA	ACCCTGTTCAAGTGAG
AAAAAAAATACGCCACTAACCAAA	ACCCTGTTCCCTGGAA
AAAAAAAAAACTAAGCTAACCAAA	ACCCTGTTCGGGATTT
AAAAAAAACAAACATACTCATGAA	ACCGAAGCAGGTTACC
AAAAAAAAGGAATAAACTCATGAA	ACCGAAGCAGTTATCG
AAAAAAAAATTGGTGACTCATGAA	ACCGAAGCATTGTTGG
AAAAAAAAGCTCAAGGATCAGCCT	ACCGGCTAGGCTACTG
AAAAAAAAGGAGCTTGATCAGCCT	ACCGGCTAGTCATTTC
AAAAAAAACAAACATACGTGGCGT	ACCGGTTCAGGTTACC
AAAAAAAAAGCTTGTCTAGGAACC	ACCTAAATCATTCATC
AAAAAAAACTCCCACCTAGGAACC	ACCTAAATCCCTGACT
AAAAAAAAGTAGTAACTAGGAACC	ACCTAAATCCTACCTA
AAAAAAAACGCAAGGCTAGGAACC	ACCTAAATCTGCAACG
AAAAAAAAGGTAATGTGCTACTAG	ACCTAAGGTCGCAATA
AAAAAAAACTATCGGCTTGATGAG	ACCTACCTCAGGGCCT
AAAAAAAACTGCTCCCTTGATGAG	ACCTACCTCTCACTAT
AAAAAAAATTTGCAACTAGTCCCG	ACCTCACTCAATGAGG
AAAAAAAAGGAGAAACTAGTCCCG	ACCTCACTCGGTTTCC
AAAAAAAATTGTTGACTAGTCCCG	ACCTCACTCTGGTCCT
AAAAAAAATGGTCCACTAGTCCCG	ACCTCACTCTTAGTGA
AAAAAAAATTGGCTGCTCATAACT	ACCTGGATCAAGCTTA
AAAAAAAATGGGTAACTCATAACT	ACCTGGATCACGCATG
AAAAAAAACGTTGCACTCATAACT	ACCTGGATCGTTACAA
AAAAAAAAAGTACTGACCGTTTGT	ACCTGGTCATTATCCC
AAAAAAAAGAGAAGGTGGACGTAA	ACCTGTTGTACCCACC
AAAAAAAATGTATTGCTCACAGAA	ACCTTCATCATCACTT
AAAAAAAAGATATAGCTCACAGAA	ACCTTCATCATTAGCA
AAAAAAAACTTTAAGCTCACAGAA	ACCTTCATCCAATTAG
AAAAAAAACGCTATGCTCACAGAA	ACCTTCATCCACCTTA
AAAAAAAACATTTAGCTCACAGAA	ACCTTCATCCCGTTAC
AAAAAAAAATGTTGCCTCACAGAA	ACCTTCATCCGTCCAT
AAAAAAAACTTGAGCCTCACAGAA	ACCTTCATCGGTTCCT
AAAAAAAACTACTAACTCACAGAA	ACCTTCATCTGTTCAT
AAAAAAAAAACTGATGAGTCATGG	ACCTTCCAGCATCCAG
AAAAAAAACCAACAAGAGTCATGG	ACCTTCCAGCCACATG
AAAAAAAATAACTTCGAGTCATGG	ACCTTCCAGCCTGGTA
AAAAAAAAAGCTTGTCTCTAGCAC	ACCTTGCTCATTCATC
AAAAAAAAGTCAATCCTCTAGCAC	ACCTTGCTCGCTATAA
AAAAAAAATTACCTTTGCTAGACT	ACCTTGTGTGTCCAGG
AAAAAAAAACATTAGGAGCGAATC	ACGAACAAGTTCCCGT
AAAAAAAAAACGGGAACTAGCCTT	ACGAAGTCAACTAACT
AAAAAAAAGTACGTAACTAGCCTT	ACGAAGTCAATATAGG
AAAAAAAAGACTCAAACTAGCCTT	ACGAAGTCAATTTGGT
AAAAAAAAGCTGAATACTAGCCTT	ACGAAGTCACAGAACG
AAAAAAAATTGGTAAACTAGCCTT	ACGAAGTCACTAAATC
AAAAAAAAAACAGCTACTAGCCTT	ACGAAGTCAGAGAGCC
AAAAAAAATGGTTAAACTAGCCTT	ACGAAGTCATCTAGCA
AAAAAAAACCGGTTACTAAGTTCC	ACGAATCTCCGTTAAA
AAAAAAAATAGGTAGCTAAGTTCC	ACGAATCTCTAATCTC
AAAAAAAAAACCTAAGAGTAATCA	ACGACTTAGAATCTCA
AAAAAAAAAACTGATGAGTAATCA	ACGACTTAGCATCCAG
AAAAAAAACAGCTAAGATAACCTT	ACGAGTAAGGCCAATT
AAAAAAAACCGTGAGGATAACCTT	ACGAGTAAGGTGTCCA
AAAAAAAAAACTAACGATAACCTT	ACGAGTAAGTCACGAT
AAAAAAAACATGTTTGATAACCTT	ACGAGTAAGTCCTGAG
AAAAAAAACGGATTAGATTTGCAT	ACGATTCAGGTTACGT
AAAAAAAAATCACCCACTCGCTCG	ACGCAAGCAAAGCCTC
AAAAAAAATGAACCGACTCGCTCG	ACGCAAGCACATACTG
AAAAAAAAGGTACGCACTCGCTCG	ACGCAAGCACTTCACT
AAAAAAAATCCATAGTGCGCGCTA	ACGCACGGTGTGTCCC
AAAAAAAATCTTAGTGATTCATGT	ACGCCTAAGCAATAGG
AAAAAAAACTTCCTTGATTCATGT	ACGCCTAAGGCTATGT
AAAAAAAACAATGAGCTGATTAGA	ACGCCTTTCCGCTAGA
AAAAAAAAGTTAAAGCTGATTAGA	ACGCCTTTCTCGCCTG
AAAAAAAAGGACCATGAAGCCTTT	ACGCTTGAGCTCAATA
AAAAAAAATAGGTACGAAGCCTTT	ACGCTTGAGGTAAGCA
AAAAAAAATGAGGCATGTTTGCAG	ACGGGAAGTGATCATG
AAAAAAAATGTTGGTTGTTTGCAG	ACGGGAAGTGCATTAG
AAAAAAAACTTTAGGTGATTAGCT	ACGGTACGTAAGCTTG
AAAAAAAAGAAGTCATGATTAGCT	ACGGTACGTCAAACTG
AAAAAAAATCCTGAATGATTAGCT	ACGGTACGTTATAGCG
AAAAAAAATTCACTTTGAAATGCG	ACGGTTAGTTAGCCAA
AAAAAAAAATGCTATTGAAATGCG	ACGGTTAGTTAGTTGG
AAAAAAAACACCATATGAAATGCG	ACGGTTAGTTTATTCG
AAAAAAAAAATAGCTGACAGGCTG	ACGGTTTAGCGATACT
AAAAAAAATGAGCGCGACAGGCTG	ACGGTTTAGCTAATCA
AAAAAAAAAATTACGGACAGGCTG	ACGGTTTAGTAACCCG
AAAAAAAACTTGAAGGACAGGCTG	ACGGTTTAGTAAGAAC
AAAAAAAAATGGAGGACAAGGTTC	ACGTACCCAAACCTTG
AAAAAAAAGCGGTCAACAAGGTTC	ACGTACCCAACCGCCA
AAAAAAAAGGTGCGTACAAGGTTC	ACGTACCCAGGGAGGA
AAAAAAAACCATCCTTGGTTAATC	ACGTCAAGTTAGAGGG
AAAAAAAATGCAGCTCTCAAGAAC	ACGTCCTTCCCTCAGT
AAAAAAAATGGAGCGCTCAAGAAC	ACGTCCTTCCGTAAAC
AAAAAAAAACTAAGACTCAAGAAC	ACGTCCTTCTTAGCCC
AAAAAAAAAACGCTAACATACTTC	ACTAAAGCAAGTAAGC
AAAAAAAAGGTATTGACATACTTC	ACTAAAGCACAAACTT
AAAAAAAAATGTTTCACATACTTC	ACTAAAGCAGCTACGT
AAAAAAAAGGTACTAACATACTTC	ACTAAAGCAGTCTAAT
AAAAAAAAGCCAGCAACATACTTC	ACTAAAGCATCGCTTT
AAAAAAAACGTTATTGAATCCGGA	ACTAACCAGGCTTAAC
AAAAAAAAAATTGTGGAATCCGGA	ACTAACCAGGTCCAAT
AAAAAAAAACCTCATGAATCCGGA	ACTAACCAGTTAGCCG
AAAAAAAACCACTAATGTTGAGTC	ACTAACGGTATTGTCC
AAAAAAAATAGTCAAACGTACCTC	ACTAACTCACATGCTA
AAAAAAAAGCAACATACGTACCTC	ACTAACTCAGTGAACG
AAAAAAAAAGTCAGTACGTACCTC	ACTAACTCATGAAATG
AAAAAAAACGTTAGGACATTAGCG	ACTAATCCAAGCTTAT
AAAAAAAATCGATTCACATTAGCG	ACTAATCCAAGGCCAA
AAAAAAAAGCGATTAACATTAGCG	ACTAATCCAGAACCGA
AAAAAAAACTAACGGACATTAGCG	ACTAATCCAGGAACTG
AAAAAAAATATGTCCACATTAGCG	ACTAATCCATAAGTTC
AAAAAAAAATTGGTGACATTAGCG	ACTAATCCATTGTTGG
AAAAAAAAAAAGTGAACATTAGCG	ACTAATCCATTTAAGC
AAAAAAAACAGGCCTTGCCGGAAA	ACTATCCGTCATGAGC
AAAAAAAAGGTTCACTGCCGGAAA	ACTATCCGTCTATCGT
AAAAAAAATTCCACCTGCCGGAAA	ACTATCCGTTGCACAA
AAAAAAAATCCGTTAACTAACGAT	ACTATGTCAATAAGCA
AAAAAAAACCGCCTAACTAACGAT	ACTATGTCACTAAGCC
AAAAAAAAACCATACCTAACCCTA	ACTCACCTCATGGCCA
AAAAAAAATTGGCCACTAACCCTA	ACTCACCTCCGGTTGA
AAAAAAAATAAGGTGCTAACCCTA	ACTCACCTCCTCACAC
AAAAAAAAGGCTTTACTAACCCTA	ACTCACCTCCTCAGCT
AAAAAAAATTCGTAACTAACCCTA	ACTCACCTCTATGACA
AAAAAAAAGCCTCAATGAGAACCA	ACTCACTGTAACGTGC
AAAAAAAATTTGTGGTGAGAACCA	ACTCACTGTACGCGCA
AAAAAAAAATTGAGGTGAGAACCA	ACTCACTGTGTGAGAG
AAAAAAAATCCTAAGTGAGAACCA	ACTCACTGTTAACGGC
AAAAAAAAAGCCTGTTGAGAACCA	ACTCACTGTTAGTACG
AAAAAAAAAGCCAAATGAGAACCA	ACTCACTGTTCTTTAG
AAAAAAAATATTCCTTGAGAACCA	ACTCACTGTTTGCAGA
AAAAAAAAAACCCTTGATATCCTA	ACTCAGTAGCGATAGA
AAAAAAAATTGAAGCGATATCCTA	ACTCAGTAGTAACAGG
AAAAAAAACACTAAGGATATCCTA	ACTCAGTAGTTCCTCA
AAAAAAAAGGACCATGAAGGCTTG	ACTCCTCAGCTCAATA
AAAAAAAAAGAGCTGCTATGGACG	ACTCGCTTCAAGTGAG
AAAAAAAACGATAAGCTATGGACG	ACTCGCTTCCCATAGG
AAAAAAAAGCGGATACTATGGACG	ACTCGCTTCCTTGAGG
AAAAAAAACCTGGAAACACGGTTA	ACTGAAACAAAGCTAA
AAAAAAAAATGGTCAACACGGTTA	ACTGAAACAGTCTATG
AAAAAAAATTGGGTTTGTCCTTTA	ACTGAATGTAACAGGG
AAAAAAAATTCCCGTTGTCCTTTA	ACTGAATGTAATCGCA
AAAAAAAAACGGTTCTGTCCTTTA	ACTGAATGTAGCTAAT
AAAAAAAATAAGCCTTGTCCTTTA	ACTGAATGTTCATTTG
AAAAAAAAGCTTGTGTGTCCTTTA	ACTGAATGTTGAAGCC
AAAAAAAAGGAGCTTGATGAGAAA	ACTTACAAGTCATTTC
AAAAAAAACGTAATGGATGAGAAA	ACTTACAAGTTACTTC
AAAAAAAATCCGGTACTACCTGCG	ACTTACTTCAATCATG
AAAAAAAACACCCTCCTACCTGCG	ACTTACTTCTAGCTAA
AAAAAAAACGTTTGGCTCCCTCAC	ACTTATCTCCTTAAGA
AAAAAAAAAATTGTGGAGGACTTG	ACTTATGAGGTCCAAT
AAAAAAAAGAATATCGAGGACTTG	ACTTATGAGTTAGCTA
AAAAAAAAGGGCAATCTAAGCTTC	ACTTCGCTCCGTGACA
AAAAAAAACTTAGCGCTAAGCTTC	ACTTCGCTCTCCTCAA
AAAAAAAACTACTAACTAAGCTTC	ACTTCGCTCTGTTCAT
AAAAAAAAGACTTACCTATTAGGA	ACTTGAATCCACCTGT
AAAAAAAAAACCTGTCTATTAGGA	ACTTGAATCCCTCATA
AAAAAAAACTGGATCCTATTAGGA	ACTTGAATCCTCATCA
AAAAAAAACCAGGTTCTATTAGGA	ACTTGAATCCTCGATC
AAAAAAAAGTTGCATCTATTAGGA	ACTTGAATCTAAGGTC
AAAAAAAACCCTAAGCTATTAGGA	ACTTGAATCTCAATTC
AAAAAAAAATGGTCAACATACCGA	ACTTGCACAGTCTATG
AAAAAAAAAGGATAAACATACCGA	ACTTGCACATGTTTGG
AAAAAAAATGTTGTTGAACAAGCC	ACTTGTAAGACAACAG
AAAAAAAAGACGAGGGAACAAGCC	ACTTGTAAGCATGTCG
AAAAAAAATACAAGCGAACAAGCC	ACTTGTAAGCGCTCAA
AAAAAAAAGTCGCTATGACCTTGG	ACTTGTCGTAAGCTCA
AAAAAAAAGGTTACCTGACCTTGG	ACTTGTCGTAGCCATA
AAAAAAAAAATACCTTGACCTTGG	ACTTGTCGTTACGCAA
AAAAAAAAGGAGGCTTGACCTTGG	ACTTGTCGTTCAAGCA
AAAAAAAATCCGTAATGACCTTGG	ACTTGTCGTTCACCAT
AAAAAAAATGATTTGCTTTAGCAT	ACTTTGTTCGTTAAGC
AAAAAAAACAGGAGGACCTCAGCC	AGAAACCCAAGGGTTG
AAAAAAAACCGCCTAACCTCAGCC	AGAAACCCACTAAGCC
AAAAAAAACATGGTGACCTCAGCC	AGAAACCCATACCCGG
AAAAAAAAAGCGCATGAAGCTATA	AGAAACTAGCAACAAG
AAAAAAAATGGGTTAGAAGCTATA	AGAAACTAGCTATGAC
AAAAAAAAGGTAGCTGAAGCTATA	AGAAACTAGTCTTGAA
AAAAAAAAGGGAACAACTCACTGT	AGAAAGGCACTCGCTC
AAAAAAAAAGAATGAACTCACTGT	AGAAAGGCAGGCTGTT
AAAAAAAACACCATTACTCACTGT	AGAAAGGCATGCATAT
AAAAAAAACTTAGTGTGCCTCATC	AGAACAAGTGAAACAA
AAAAAAAAGTTAGCGGATAGATGC	AGAACCAAGCTTAGTA
AAAAAAAAGACCTAGGATAGATGC	AGAACCAAGTAAGTCC
AAAAAAAAGGCAGGTTGCATCACA	AGAAGGTGTAACCTAG
AAAAAAAATCCGTAATGCATCACA	AGAAGGTGTTCACCAT
AAAAAAAAGTACTTCGAGGCACAT	AGAATCGAGAGGATAT
AAAAAAAAATTCCTGGAGGCACAT	AGAATCGAGGTATTGC
AAAAAAAACGATTGAGAGGCACAT	AGAATCGAGGTGAAAT
AAAAAAAACGTCAATTGACTTCGG	AGAATCTGTAGCTAGC
AAAAAAAAGGGTAATTGACTTCGG	AGAATCTGTTCAAGAT
AAAAAAAAATGGATTGAATATGGT	AGACAATAGGCCCAGT
AAAAAAAACCGCTTAGAATATGGT	AGACAATAGTAAAGGT
AAAAAAAACCGCTATGAATATGGT	AGACAATAGTTGCGTG
AAAAAAAATTAAGGTACCAAGTCG	AGACACGCAGTAGGTG
AAAAAAAAGCAATTGACCAAGTCG	AGACACGCATTGACAT
AAAAAAAAGATAGACTGTCCATCC	AGACCCGGTATTGTGG
AAAAAAAAAGAGGGATGCCTCACT	AGACTATGTAAGCACC
AAAAAAAATACCTGATGCCTCACT	AGACTATGTCCGTAGG
AAAAAAAAGAGAGCAACTATCCTG	AGAGAAGCAGGACCTT
AAAAAAAAGCAACATACTATCCTG	AGAGAAGCAGTGAACG
AAAAAAAAACGCCTCGAGCTGCAA	AGAGAGGAGCTTAGCG
AAAAAAAAGATTCCTGAGCTGCAA	AGAGAGGAGGACCTCA
AAAAAAAATCATGGAGAAGTAATC	AGAGATTAGACCATAC
AAAAAAAACCATAAGGAAGTAATC	AGAGATTAGTTGGCCA
AAAAAAAAACACCTTGAAGTAATC	AGAGATTAGTTGTCTT
AAAAAAAAATGAGAAACATTGTTC	AGAGGAACACAATACT
AAAAAAAAACTGACAACATTGTTC	AGAGGAACACAGGAAT
AAAAAAAATAGTCAAACATTGTTC	AGAGGAACACATGCTA
AAAAAAAATCGAAGCACATTGTTC	AGAGGAACATTGTGGC
AAAAAAAACTGACCGTGTTTGAGC	AGAGGATGTAAAGCGG
AAAAAAAATGTTGCATGTTTGAGC	AGAGGATGTCAAAGGG
AAAAAAAACATGAAATGTTTGAGC	AGAGGATGTCGTAAAT
AAAAAAAATATGGCTTGTTCGGGC	AGATGAAGTCACACCC
AAAAAAAAAGAAACCTGTTCGGGC	AGATGAAGTCATTAGG
AAAAAAAAAGTAACGTGTTCGGGC	AGATGAAGTCTAGCTT
AAAAAAAAACCCTCCTGTTCGGGC	AGATGAAGTGGAAACG
AAAAAAAACACAGGATGTTCGGGC	AGATGAAGTTATGTGG
AAAAAAAAGTGGACACTTTAAGTC	AGATGCTTCACTTCAT
AAAAAAAAATATCGCCTTTAAGTC	AGATGCTTCATAAGCC
AAAAAAAAGGAATATCTTTAAGTC	AGATGCTTCCAAACAC
AAAAAAAATACATACCTTTAAGTC	AGATGCTTCGAGCTAT
AAAAAAAACATGGCGGAGATTATG	AGCAAATAGCACTAGT
AAAAAAAAAGAGGATGAGATTATG	AGCAAATAGCATGGTT
AAAAAAAATGGTGCGGAGATTATG	AGCAAATAGCTGGACC
AAAAAAAACATGATGGAGATTATG	AGCAAATAGGCCTTAG
AAAAAAAAACAGGCTGAGGTTTGG	AGCAACAAGGTCGAGG
AAAAAAAATGACAACGAGGTTTGG	AGCAACAAGTACCGCA
AAAAAAAAGTGATGATGTGAGGCA	AGCAAGGGTAACCACA
AAAAAAAACCTTTATTGTGAGGCA	AGCAAGGGTCATCCTG
AAAAAAAATGGTGTGACTGGTCTT	AGCAATACACAAAGGT
AAAAAAAACAGCGATACTGGTCTT	AGCAATACACCTAAGC
AAAAAAAAGGTTAACACTGGTCTT	AGCAATACATTATGCG
AAAAAAAAGCAGTAATGTTGTTCT	AGCAATTGTATTGGAT
AAAAAAAAGGCATGGTGTTGTTCT	AGCAATTGTCATAGAT
AAAAAAAAGTTTGGCTGTTGTTCT	AGCAATTGTGATCAGC
AAAAAAAACTTTGTTTGTTGTTCT	AGCAATTGTTCGGTAA
AAAAAAAATAGAGATTGTTGTTCT	AGCAATTGTTTGGCTT
AAAAAAAAAGGAGCAACCTGGAAC	AGCACAGCAAAGCGCA
AAAAAAAAAGTGAGGACCTGGAAC	AGCACAGCAATAGCAA
AAAAAAAAGCGTGACACCTGGAAC	AGCACAGCACTAAGAA
AAAAAAAAGGGAACAACCTGGAAC	AGCACAGCACTCGCTC
AAAAAAAACGATTACTGATGGCGG	AGCACTAGTGCTAGAC
AAAAAAAACCAACAAGACTATGTT	AGCACTTAGCCACATG
AAAAAAAAACAGCCAGACTATGTT	AGCACTTAGCTAAGTC
AAAAAAAAGCATAATGACTATGTT	AGCACTTAGGATCACT
AAAAAAAAAATTACGGACTATGTT	AGCACTTAGTAACCCG
AAAAAAAAGAATATCGACTATGTT	AGCACTTAGTTAGCTA
AAAAAAAATATCCGCGATGACAAC	AGCAGGTAGATACTTG
AAAAAAAATAGCACAGATGACAAC	AGCAGGTAGGACCAGG
AAAAAAAAAGTAGAGGATGACAAC	AGCAGGTAGGAGTAAT
AAAAAAAATATGTCCACGCAAGCC	AGCATCCCATAAGTTC
AAAAAAAATACAACAACCCTAAGG	AGCATTTCAACTAGCC
AAAAAAAAGGACTTAACCCTAAGG	AGCATTTCATCCCTCA
AAAAAAAAACCAATCCTGTTAGCT	AGCCGGTTCGCTTCTA
AAAAAAAAGCCTCTCTGGATGTAG	AGCCTAAGTCCTCCAA
AAAAAAAATGCTTGATGGATGTAG	AGCCTAAGTTGGTGAC
AAAAAAAATCGGTATTGGATGTAG	AGCCTAAGTTTAGTCC
AAAAAAAATAGAAACTGCAGCAAG	AGCCTCCGTCGACTAA
AAAAAAAAGTCGAGGTGCAGCAAG	AGCCTCCGTTAATGCG
AAAAAAAAAGGGATTTGCAGCAAG	AGCCTCCGTTGTAAAC
AAAAAAAAGTGCTGGACTAAATCG	AGCGGACCACCCACCT
AAAAAAAAACGGATCGAAACAAGG	AGCGGATAGCCACAAT
AAAAAAAAGATGAAGGAAACAAGG	AGCGGATAGCCTGAGC
AAAAAAAACAATGCGACAATGAAG	AGCTAAACAAGCCAGA
AAAAAAAATACGTGCCTCACTCAG	AGCTAACTCAGGCTAT
AAAAAAAACCAGGTTCTCACTCAG	AGCTAACTCCTCGATC
AAAAAAAACGGCAAGCTCGATTAT	AGCTACGTCCAAATCA
AAAAAAAAAGTAATGCTCGATTAT	AGCTACGTCCTTCAAT
AAAAAAAAGGGAGGACTCGATTAT	AGCTACGTCTCACATT
AAAAAAAAGTTAGCGGATCCAATT	AGCTACTAGCTTAGTA
AAAAAAAACAGTTAGGATCCAATT	AGCTACTAGTAAGTGG
AAAAAAAATAGCCCTGATCCAATT	AGCTACTAGTGAACCT
AAAAAAAACATAGCCCTGGTTAAA	AGCTAGTTCATTGTCT
AAAAAAAATTAAGTCCTTCATTGA	AGCTATATCGGTTACG
AAAAAAAACGTTGCACTTCATTGA	AGCTATATCGTTACAA
AAAAAAAAGCCATAAACATACTGG	AGCTGCTCACCTGTAA
AAAAAAAAGGGAGTAACATACTGG	AGCTGCTCAGCATGAG
AAAAAAAATGCGGGACTACTTCGA	AGCTTAATCACACAGT
AAAAAAAAACGGAACCTACTTCGA	AGCTTAATCATCCACC
AAAAAAAAATGTTGCCTACTTCGA	AGCTTAATCCGTCCAT
AAAAAAAAGAAGCCACTACTTCGA	AGCTTAATCGGCTATG
AAAAAAAAATACCTGCTGCGCCTA	AGCTTGGTCATAACTG
AAAAAAAACTGATTTGAGAGGAAT	AGCTTTAAGCTTTGTT
AAAAAAAATGGTTAGGAGAGGAAT	AGCTTTAAGGAACCGG
AAAAAAAACGGATTAGAGAGGAAT	AGCTTTAAGGTTACGT
AAAAAAAAGGCTCCTGAGAGGAAT	AGCTTTAAGTATTGTG
AAAAAAAAGTACAATGAGAACCGT	AGGAACCAGATTCCTT
AAAAAAAACTTGACCGAGAACCGT	AGGAACCAGGCCATCA
AAAAAAAAGGTAGCTGAGAACCGT	AGGAACCAGTCTTGAA
AAAAAAAATCATGAGGATCCTGAC	AGGACGTAGTTTGTCT
AAAAAAAAGCACTAGGATGTTGTT	AGGACTAAGCTAATTG
AAAAAAAACTGCTGTGATGTTGTT	AGGACTAAGGGATGAC
AAAAAAAATCTTAGTGACTCGCTA	AGGAGCTAGCAATAGG
AAAAAAAATTGCTTAGATTACTGT	AGGATATAGACAAAGT
AAAAAAAAGAAGTTTGATTACTGT	AGGATATAGCATGTTA
AAAAAAAAGATTCCTGATTACTGT	AGGATATAGGACCTCA
AAAAAAAAAGCAATTGATTACTGT	AGGATATAGTCTATGA
AAAAAAAAACACCTTGATTACTGT	AGGATATAGTTGTCTT
AAAAAAAAGAGCTGGTGGACCTCA	AGGATCCGTGCATTTC
AAAAAAAAGTACGTAACGTATTTC	AGGATGTCAATATAGG
AAAAAAAATATAGTGACGTATTTC	AGGATGTCAGCTCAAC
AAAAAAAAAGTTACAGAAGCCATG	AGGATTGAGCTAGAAG
AAAAAAAAGCGGTGTACTGACCAG	AGGCAATCACCTGCTC
AAAAAAAATGGGAGGACTGACCAG	AGGCAATCATAACGGG
AAAAAAAAGGACTTAACTGACCAG	AGGCAATCATCCCTCA
AAAAAAAACCATGACCTTATTGCA	AGGCAGGTCATGCAAC
AAAAAAAATAGCAAGCTTATTGCA	AGGCAGGTCATTAGGC
AAAAAAAACTTGCTTCTTATTGCA	AGGCAGGTCCTCAGTC
AAAAAAAAGTGATGATGTTGAGGG	AGGCCCAGTAACCACA
AAAAAAAAACAAACACTATTGACC	AGGCGGATCAGCACCA
AAAAAAAATGCGTGTCTATTGACC	AGGCGGATCCTGGTGA
AAAAAAAAGTCCTGGCTATTGACC	AGGCGGATCGCTAGCA
AAAAAAAAGTTAGGCGACCGGGTA	AGGCTAAAGCAGGTTT
AAAAAAAAGCAACTAACTAGCGAC	AGGCTAGCAACTAGGG
AAAAAAAAGAGAAGCACTAGCGAC	AGGCTAGCATGTGGGA
AAAAAAAACTAAGGACTTAAGGTG	AGGGCCTTCATTATGG
AAAAAAAACGCTTAGCTTAAGGTG	AGGGCCTTCCTTCTAG
AAAAAAAAGAGGTGAACGGGAACA	AGGGCTACACACTAAT
AAAAAAAAGTGGATTACGGGAACA	AGGGCTACAGCAACAG
AAAAAAAAGTTCACCACGGGAACA	AGGGCTACAGCTTAAT
AAAAAAAATAGTCTCACGGGAACA	AGGGCTACATTAAGTC
AAAAAAAAGAACCGCACTAGCGGT	AGGTAACCAGGAACAT
AAAAAAAAAGAATGAACTAGCGGT	AGGTAACCAGGCTGTT
AAAAAAAATATGTCCACTAGCGGT	AGGTAACCATAAGTTC
AAAAAAAACCAGCAAACCTTGCAT	AGGTACGCACCAGGTT
AAAAAAAAGCTTATTACCTTGCAT	AGGTACGCATAAAGCA
AAAAAAAATTCCGGCACCTTGCAT	AGGTACGCATATTGAC
AAAAAAAAAGTCATTTGTGGGAAC	AGGTATTGTATGTGGC
AAAAAAAACCATCACGAGGTGAGG	AGGTCAAAGCTACTGG
AAAAAAAACGTAGTAGAGGTGAGG	AGGTCAAAGGATAAAC
AAAAAAAACTTGAAGGAGGTGAGG	AGGTCAAAGTAAGAAC
AAAAAAAATAGCCCTGAGGTGAGG	AGGTCAAAGTGAACCT
AAAAAAAAGTTGACGGAGGTGAGG	AGGTCAAAGTTCCTGC
AAAAAAAACATAATCCTAGCGAGT	AGGTCATTCACGAATC
AAAAAAAAGAGGGAGCTAGCGAGT	AGGTCATTCATGCTCC
AAAAAAAAACTGAGCGATATTGGG	AGGTCTTAGCTAAAGG
AAAAAAAAGTAATGTGATATTGGG	AGGTCTTAGGAGGACT
AAAAAAAAACATTGCCTGACCGCT	AGGTGAATCAGAAACG
AAAAAAAAGCAATAACTGACCGCT	AGGTGAATCCAGGGAG
AAAAAAAAAGTCCCGCTGACCGCT	AGGTGAATCCTGCGAA
AAAAAAAAAGCAAACTGTAACCTG	AGGTGAGGTAATCGGC
AAAAAAAAGTTCCTTTGTAACCTG	AGGTGAGGTGGTTATG
AAAAAAAAAGCCGGTACAAGCGTT	AGGTTAACACAGACTC
AAAAAAAATGGCGTAACAAGCGTT	AGGTTAACAGGTATTT
AAAAAAAAGCCAGCAACAAGCGTT	AGGTTAACATCGCTTT
AAAAAAAAAGGCTGTGAGGCAATC	AGGTTAGAGGCTAGAA
AAAAAAAAGCATATTTGATAATCC	AGGTTGCGTAAACAAG
AAAAAAAAGTGTAATGAGTCCCTG	AGTAAACAGGATTTGC
AAAAAAAATCAGTTTGAGTCCCTG	AGTAAACAGTTAGGCT
AAAAAAAAGAGCGCTACTAATAGC	AGTAACACAACCTGGT
AAAAAAAACTAGTCTACTAATAGC	AGTAACACAGTTTACG
AAAAAAAACACCACACTCAATCTA	AGTAACCTCACCTGTC
AAAAAAAACTTTAAGCTCAATCTA	AGTAACCTCCAATTAG
AAAAAAAACTTAGCGCTCAATCTA	AGTAACCTCTCCTCAA
AAAAAAAACTTAATGCTCAATCTA	AGTAACCTCTTAGGGT
AAAAAAAATATTGCTGAAGCAACC	AGTAACGAGGAACACA
AAAAAAAAACCTCGCGATCCGCAT	AGTAAGTAGCACTAAC
AAAAAAAATGCTTCCTGCGAGTGA	AGTAATCGTAGCAGCT
AAAAAAAATGGAGCATGCGAGTGA	AGTAATCGTCATTGAG
AAAAAAAAAAGCCTAACCTACCTA	AGTAATGCATATAACC
AAAAAAAAATTTGCGCTCACTGTG	AGTAGCTTCCTTTACG
AAAAAAAAGAATTGACTCACTGTG	AGTAGCTTCTCATCAT
AAAAAAAATGCATTACTATGTCCA	AGTAGGATCAGCAAAG
AAAAAAAATGAGTGACTATGTCCA	AGTAGGATCCTGGCTT
AAAAAAAACTCTATGACACCATGA	AGTATAGCACACCAAC
AAAAAAAAGTAGGTTACACCATGA	AGTATAGCAGGCGAGT
AAAAAAAAATGGTCAACACCATGA	AGTATAGCAGTCTATG
AAAAAAAAGATTGCGGATCAGTAG	AGTCAAGAGTGAACAG
AAAAAAAATTGTTGGTGTTGGATC	AGTCAATGTAGGTTTG
AAAAAAAAGGTACGCACTCATAGA	AGTCAGGCACTTCACT
AAAAAAAACTTTAACGAAATAACC	AGTCCTGAGCTATATG
AAAAAAAAAGAATCGTGTTGCTCC	AGTCCTTGTACCGGAT
AAAAAAAAACTCAATTGTTGCTCC	AGTCCTTGTGGTGAGA
AAAAAAAAGAATGCATGTTGCTCC	AGTCCTTGTTAGCATG
AAAAAAAAGTCCTAACTTGCACAC	AGTCGCATCCCATAAA
AAAAAAAAGTGCAAGCTTGCACAC	AGTCGCATCCGCCTAT
AAAAAAAAATAGCTCCTTGCACAC	AGTCGCATCCTTAATC
AAAAAAAAGTGATGGCTTGCACAC	AGTCGCATCTTGCTAT
AAAAAAAAGGTAACTACCGGTTAG	AGTCTTGCAACAGGAT
AAAAAAAACCACTTAACCGGTTAG	AGTCTTGCACATTGCA
AAAAAAAACCATTGTACCGGTTAG	AGTCTTGCATAAGGAC
AAAAAAAAAGTCACAACCAACAGC	AGTGAACCAAATATCC
AAAAAAAAATACCGAACCAACAGC	AGTGAACCACCAGCAT
AAAAAAAAACCCTCAACCAACAGC	AGTGAACCAGCATTAT
AAAAAAAATATGCTCACCAACAGC	AGTGAACCAGGGAGCT
AAAAAAAATGACATAACACAATGC	AGTGAGTCATTAAACC
AAAAAAAATGTAAGTACACAATGC	AGTGAGTCATTATGGT
AAAAAAAAAAACCATGAGCTAAGC	AGTGATGAGATAAAGC
AAAAAAAACATGATGGAGCTAAGC	AGTGATGAGGCCTTAG
AAAAAAAAGCTGTCATGTGATCCA	AGTGCACGTCAAGTAT
AAAAAAAAACTTCCTTGAGCTAGA	AGTGCCGGTATTGCAG
AAAAAAAAGGAACAAGATCCAACC	AGTGGACAGCACTTGG
AAAAAAAATGCGTGAACAAGGTAA	AGTGTTTCACATTAAC
AAAAAAAACTTAAGAACAAGGTAA	AGTGTTTCATAATTGC
AAAAAAAATAGTCTCACAAGGTAA	AGTGTTTCATTAAGTC
AAAAAAAAGACTCAAACCTGGATG	AGTTACTCAATTTGGT
AAAAAAAAGTGAGGAACCTGGATG	AGTTACTCACGTAATT
AAAAAAAAAGAAATGACCTGGATG	AGTTACTCACTTAGGC
AAAAAAAAAAGATAGACCTGGATG	AGTTACTCAGCTTAGC
AAAAAAAATTAATGGACCTGGATG	AGTTACTCATTAGCCA
AAAAAAAATCCGGTACTTACCGTG	AGTTATGTCAATCATG
AAAAAAAACCTTGAGCTTACCGTG	AGTTATGTCATAATCG
AAAAAAAATGTCCTTCTTACCGTG	AGTTATGTCTACTAAG
AAAAAAAACTTCTATTGATCAATC	AGTTGCAGTGAGCACT
AAAAAAAAGCGTTTGTGATCAATC	AGTTGCAGTGTTTGTC
AAAAAAAAACATTGCCTTCGTAAT	AGTTTGATCAGAAACG
AAAAAAAACAACGGTACAGGCGAA	ATAACGACAGCAGGTA
AAAAAAAACCAGGTTCTGAAACAT	ATAAGCCTCCTCGATC
AAAAAAAAGGTTATCCTGAAACAT	ATAAGCCTCGTTATAG
AAAAAAAAATGGAGGACCTGGTCC	ATAATGGCAAACCTTG
AAAAAAAATACTCACACCTGGTCC	ATAATGGCATCCCGCT
AAAAAAAATTCACCAACCTGGTCC	ATAATGGCATTCCTCG
AAAAAAAAGCTATTGCTGGTAAAT	ATACCGGTCTAAGTGC
AAAAAAAACACTATACTGGTAAAT	ATACCGGTCTGGCATG
AAAAAAAACAATGCGACGAACAGG	ATACCTGCAAGCCAGA
AAAAAAAACTTAACCACGAACAGG	ATACCTGCAATTAGGA
AAAAAAAAGTACGTAACAACTACG	ATAGATGCAATATAGG
AAAAAAAAACAAAGAACAACTACG	ATAGATGCATAATCGT
AAAAAAAAGTTTAACTGTGCACCG	ATAGCATGTGATGAGG
AAAAAAAATATGACAACCTCAGGA	ATAGGTACAATTATGC
AAAAAAAACTGCACCACCTCAGGA	ATAGGTACAGGCATGA
AAAAAAAAACTGCAAACCTCAGGA	ATAGGTACAGTTATGT
AAAAAAAAGCGCTAGACAAGTGGG	ATATAGGCAAGGTACG
AAAAAAAATAATTGGACAAGTGGG	ATATAGGCACAATGCC
AAAAAAAATCCTAGTACAAGTGGG	ATATAGGCACTATGGC
AAAAAAAAAAGACAAACAAGTGGG	ATATAGGCATCCTAGA
AAAAAAAATCAATTGCTTGAACAG	ATATGCATCTCCATAT
AAAAAAAATTTAGGCTGTAGCCCG	ATATGGTGTGGAGCAA
AAAAAAAAGAATCACACCTTAGTC	ATATGTCCATTGCGTA
AAAAAAAAGGTGAGAACAGGTGAG	ATCAAGACAACGTGCT
AAAAAAAATCCCTCTACAGGTGAG	ATCAAGACAATCATGT
AAAAAAAAGGTGATTACAGGTGAG	ATCAAGACAGCACGAA
AAAAAAAATTACTGCACAGGTGAG	ATCAAGACAGTATGTT
AAAAAAAATATGATGACAGGTGAG	ATCAAGACATAGCTGC
AAAAAAAATAAACCAACAGGTGAG	ATCAAGACATTGCAGC
AAAAAAAATGCAAGACTGGTCATT	ATCAAGCTCAACCAAC
AAAAAAAAGGGTGAAACCTTCTAG	ATCAATCCAATGCGCT
AAAAAAAAGAGGTGAACCTTCTAG	ATCAATCCACACTAAT
AAAAAAAAATGCTTTACCTTCTAG	ATCAATCCATCACTTC
AAAAAAAACTTAGGCCTCAAGGGC	ATCACAATCAATCTCT
AAAAAAAATAGGAGTCTCAAGGGC	ATCACAATCACTAATG
AAAAAAAAAGGTGCACTCAAGGGC	ATCACAATCAGGTTTA
AAAAAAAATGTCCTTCTCAAGGGC	ATCACAATCTACTAAG
AAAAAAAACTTTAACGAGGGAGGT	ATCACACAGCTATATG
AAAAAAAACCTTACGGAGGGAGGT	ATCACACAGGAGCATA
AAAAAAAATTGAAGCGAATTAGAC	ATCACTAAGTAACAGG
AAAAAAAAAATGAGGGAATTAGAC	ATCACTAAGTAGCCAT
AAAAAAAAAGCAAGCCTCACTAAT	ATCAGGTTCACCATTT
AAAAAAAATCAAGGACTCACTAAT	ATCAGGTTCATAGACC
AAAAAAAAATTGCTCGAGTCGCAA	ATCATCAAGCCATCAG
AAAAAAAATACTCGCGAGTCGCAA	ATCATCAAGCTGTCAG
AAAAAAAAGATTTAGGAGTCGCAA	ATCATCAAGGAGCAAC
AAAAAAAAGTAGCTGGAGTCGCAA	ATCATCAAGGGTTAGA
AAAAAAAACTAGTAGGAGGGTTAC	ATCCAACAGCCGGTAC
AAAAAAAACTTGAAGGAGGGTTAC	ATCCAACAGTAAGAAC
AAAAAAAAGATCCTACTGATCACT	ATCCACCTCAATTGGC
AAAAAAAAATACCTGCTGATCACT	ATCCACCTCATAACTG
AAAAAAAAAACCTGTCTGATCACT	ATCCACCTCCCTCATA
AAAAAAAAATAGTGACTGATCACT	ATCCACCTCCGCATGA
AAAAAAAAAGTCATCCTGATCACT	ATCCACCTCGTGCTAG
AAAAAAAAACGGATCGAATCCGTT	ATCCATAAGCCACAAT
AAAAAAAACTATCGCGAATCCGTT	ATCCATAAGTCACTCC
AAAAAAAATAATCCGTGCGGATCC	ATCCCGCGTTAACAGT
AAAAAAAACTACTGATGCGGATCC	ATCCCGCGTTACTTGC
AAAAAAAACGCTAAAGATGAGGAG	ATCCGTGAGACAACGA
AAAAAAAAAAGTGAGGATGAGGAG	ATCCGTGAGACAAGTG
AAAAAAAAGTGTTTGCTGGACCCT	ATCCTCATCACCAATA
AAAAAAAAAACTTCGCTGGACCCT	ATCCTCATCAGCATTA
AAAAAAAACCTTGTTCTGGACCCT	ATCCTCATCATCCTCA
AAAAAAAACACCCTCCTGGACCCT	ATCCTCATCTAGCTAA
AAAAAAAACCACTTAACCGTTATC	ATCCTGACACATTGCA
AAAAAAAAGGTACTAACCGTTATC	ATCCTGACAGTCTAAT
AAAAAAAATAGACAATGGTCCTGA	ATCCTTAGTTAAATGC
AAAAAAAAGAGGTGAACAACCTAG	ATCGAGGCACACTAAT
AAAAAAAATGATCCTACAACCTAG	ATCGAGGCACTGGCTG
AAAAAAAATAAACGTACAACCTAG	ATCGAGGCAGCAATAA
AAAAAAAAGCCATCATGTTCTTAC	ATCGCCCGTAGTAAGA
AAAAAAAATCCCGGATGTTCTTAC	ATCGCCCGTAGTTAAC
AAAAAAAACTACTGATGTTCTTAC	ATCGCCCGTTACTTGC
AAAAAAAAATATAGCGATTATTGC	ATCGGCCAGTTAACCA
AAAAAAAATTGCTTAGACAAGAAA	ATCTATGAGACAAAGT
AAAAAAAATACTGAGGACAAGAAA	ATCTATGAGCACAGCC
AAAAAAAAGTAACGCGACAAGAAA	ATCTATGAGCCTCTGT
AAAAAAAAAATCCGGGACAAGAAA	ATCTATGAGTTAGACC
AAAAAAAACCGAAGCGACAAGAAA	ATCTATGAGTTTGGTA
AAAAAAAAAAGAACAACGCTAAGT	ATGAAGCCAAACATAG
AAAAAAAAGCTGGTGACGCTAAGT	ATGAAGCCATGCTATG
AAAAAAAATTAATGGACGCTAAGT	ATGAAGCCATTAGCCA
AAAAAAAATAAACCAACGCTAAGT	ATGAAGCCATTGCAGC
AAAAAAAACCATTACACGCTAAGT	ATGAAGCCATTGTGAT
AAAAAAAAGTCTTTAACCGACTCC	ATGAATGCACAATGTT
AAAAAAAAATGCTTTACCGACTCC	ATGAATGCATCACTTC
AAAAAAAATTCACCAACCGACTCC	ATGAATGCATTCCTCG
AAAAAAAACGTTAGGACGTTAAGC	ATGACAACAAGCTTAT
AAAAAAAATCCTAGTACGTTAAGC	ATGACAACACTATGGC
AAAAAAAAAATCGTGACGTTAAGC	ATGACAACAGTTTCTC
AAAAAAAAAAGCCTAACGTTAAGC	ATGACAACATATAACC
AAAAAAAAACCGGACACGTTAAGC	ATGACAACATTAGGCC
AAAAAAAAACGTATTTGCCACAAT	ATGACCAGTACCGTTT
AAAAAAAAGTTGCTGTGCCACAAT	ATGACCAGTATACTGG
AAAAAAAATATTGGCTGCCACAAT	ATGACCAGTCACAGAC
AAAAAAAAGACATCCTGCCACAAT	ATGACCAGTCTAACAG
AAAAAAAAGTTATTGTGCCACAAT	ATGACCAGTGGACCTG
AAAAAAAAACACCGTTGCCACAAT	ATGACCAGTTATTGCC
AAAAAAAAGTTAGTTTGCCACAAT	ATGACCAGTTGAGGTC
AAAAAAAACTATATCGAACGAATT	ATGACGAAGCGAGCGA
AAAAAAAACGAGTTAGATAGCCTC	ATGACTCAGCACGATT
AAAAAAAAGACGAGGGATAGCCTC	ATGACTCAGCATGTCG
AAAAAAAAATGAGGAGATAGCCTC	ATGACTCAGCATTATG
AAAAAAAAGATGGCTGATAGCCTC	ATGACTCAGGACACTT
AAAAAAAAGCCGATAGATAGCCTC	ATGACTCAGTAACGAG
AAAAAAAACAGAACCACTAGGCTG	ATGATGACAGCCAGAA
AAAAAAAAGGTGTTAACTAGGCTG	ATGATGACAGGTTAAA
AAAAAAAAGATGACTACTAGGCTG	ATGATGACATAGCAGG
AAAAAAAAGAGGTGGGAACAAAGG	ATGATGGAGAGGGACT
AAAAAAAAAGAGGATGAACAAAGG	ATGATGGAGCATGGTT
AAAAAAAAGCTCAGGACTCGATAA	ATGCAAACACTGGCCA
AAAAAAAAAGCCGGTACCTAACCT	ATGCAGGCACAGACTC
AAAAAAAATGACATAACCTAACCT	ATGCAGGCATTAAACC
AAAAAAAAGTGGCCAACTGACTTC	ATGCATTCAAGTTATC
AAAAAAAATGCACAGACTGACTTC	ATGCATTCACCGGCTA
AAAAAAAAGAATTTGGAAACACGC	ATGCCTGAGCATTTCT
AAAAAAAAATGGACCGAAACACGC	ATGCCTGAGCGAGTAA
AAAAAAAACTGATTTGAAACACGC	ATGCCTGAGCTTTGTT
AAAAAAAACGCTTGTGAAACACGC	ATGCCTGAGTAACGGA
AAAAAAAAGAATATCGAAACACGC	ATGCCTGAGTTAGCTA
AAAAAAAACCAGAAACTTGCATTA	ATGCGATTCCTAAGTA
AAAAAAAATTTATGGCTTGCATTA	ATGCGATTCGGTACGC
AAAAAAAAGTACAATGAACTAATG	ATGCTTAAGATTCCTT
AAAAAAAACACAGGCGAACTAATG	ATGCTTAAGGACTTAC
AAAAAAAAAGTTACAGATTCATCA	ATGGACAAGCTAGAAG
AAAAAAAACTTTAACGATTCATCA	ATGGACAAGCTATATG
AAAAAAAATGTGATGGATTCATCA	ATGGACAAGGCAATAG
AAAAAAAACTGCTGTGATTCATCA	ATGGACAAGGGATGAC
AAAAAAAAGGTAACCGATTCATCA	ATGGACAAGTAAGGGC
AAAAAAAATTTAGCTGATTCATCA	ATGGACAAGTAATCCA
AAAAAAAACGATTGAGAGCTATGG	ATGGCCCAGGTGAAAT
AAAAAAAAAAGCTTAGAGCTATGG	ATGGCCCAGTTAGAGG
AAAAAAAAGTGCGAGTGGATTGCC	ATGGCTAGTATTGAGT
AAAAAAAAGCCAGGATGGATTGCC	ATGGCTAGTTATCGAG
AAAAAAAATAGAGATTGGATTGCC	ATGGCTAGTTTGGCTT
AAAAAAAATACGTTACTTCATGCG	ATGGCTGTCAAACTCA
AAAAAAAATATCCATGATAAACCG	ATGGCTTAGAGCCGGA
AAAAAAAACCATGCTGATAAACCG	ATGGCTTAGTTCCCAC
AAAAAAAAAAGTTTGGACATAACG	ATGGTCTAGCGGATTT
AAAAAAAACATGATGGACATAACG	ATGGTCTAGGCCTTAG
AAAAAAAAAGTCTTGCTATGTTGC	ATGGTTATCAAGCTAC
AAAAAAAAAGTCGAGCTATGTTGC	ATGGTTATCATGCTAA
AAAAAAAACTTGAGCCTATGTTGC	ATGGTTATCGGTTCCT
AAAAAAAAGAGAAGCACTAGGCGT	ATGTAAGCATGTGGGA
AAAAAAAATGTAATGACTAGGCGT	ATGTAAGCATTAAAGG
AAAAAAAACTACTGGCTAAATGCA	ATGTCAATCCCTGTTA
AAAAAAAAGTTCAAGACCCAGCTC	ATGTCATCACCGGTAT
AAAAAAAATTAAGGTACCCAGCTC	ATGTCATCAGTAGGTG
AAAAAAAATTCCGGCACCCAGCTC	ATGTCATCATATTGAC
AAAAAAAAAACTTGGACCCAGCTC	ATGTCATCATGCTTAG
AAAAAAAAACGCGCAACAGGCGCT	ATGTCCACATAGACTT
AAAAAAAAGAATTTGGACGTAGTA	ATGTGAGAGCATTTCT
AAAAAAAACCGGTTTGACTAGTTT	ATGTTCAAGCGCATTG
AAAAAAAAGTGATTAGACTAGTTT	ATGTTCAAGGTCCGTA
AAAAAAAATGAATTGACGCCGGTA	ATGTTGTCAATAATGG
AAAAAAAAGGTTAATGATTGTGGA	ATGTTTGAGAACCTAC
AAAAAAAATGATCAGGATTGTGGA	ATGTTTGAGAATCGCT
AAAAAAAAAATTACGGATTGTGGA	ATGTTTGAGTAACCCG
AAAAAAAAGTCATAGACAAATAGG	ATTAACCCAAGCGATG
AAAAAAAATAAGGTTACAAATAGG	ATTAACCCACGAATCC
AAAAAAAATTTGTGCACAAATAGG	ATTAACCCATAGGCGA
AAAAAAAATTCCGGCACAAATAGG	ATTAACCCATATTGAC
AAAAAAAACTACCGCACAAATAGG	ATTAACCCATTTGCTC
AAAAAAAAGGTTACCTGGGTGTGG	ATTACCCGTAGCCATA
AAAAAAAAGGATTAGTGGGTGTGG	ATTACCCGTATTCGTC
AAAAAAAATGTTGCATGGGTGTGG	ATTACCCGTCAAAGGG
AAAAAAAACTACTGATGGGTGTGG	ATTACCCGTTACTTGC
AAAAAAAAGAACCTAACTTATGAG	ATTACCGCAGCTTACA
AAAAAAAAGAAACCTACTTATGAG	ATTACCGCAGGCATCT
AAAAAAAAATGCTTTACTTATGAG	ATTACCGCATCACTTC
AAAAAAAACATCGTTACCTCAGTT	ATTACGTCAACATAAG
AAAAAAAAGGCCAGTACCTCAGTT	ATTACGTCACCAACCG
AAAAAAAATCCTAGTACCTCAGTT	ATTACGTCACTATGGC
AAAAAAAATATGCTCACCTCAGTT	ATTACGTCAGGGAGCT
AAAAAAAATGTAATGACCTCAGTT	ATTACGTCATTAAAGG
AAAAAAAACTATTTGGACATCAAG	ATTACTGAGATGCCTG
AAAAAAAATCGACCTGACATCAAG	ATTACTGAGGATCCGC
AAAAAAAATGACAAATGCAAGTAA	ATTAGCGGTTTAACGG
AAAAAAAATGAATTGACAAACTGC	ATTAGCTCAATAATGG
AAAAAAAACAACATAACAAACTGC	ATTAGCTCAGGAACCA
AAAAAAAACATGGTGACAAACTGC	ATTAGCTCATACCCGG
AAAAAAAAATTGGGATGCAAGGAC	ATTAGGTGTTGCGGAT
AAAAAAAAAACCACAACGTGCTTC	ATTAGTCCAAGGTCGA
AAAAAAAAGAGAGCAACGTGCTTC	ATTAGTCCAGGACCTT
AAAAAAAATCCTCTACTGCACACC	ATTATCCTCGCACACA
AAAAAAAAGGTCATTCTGCACACC	ATTATCCTCGCTAGAT
AAAAAAAATAGGTGACTGCACACC	ATTATCCTCTTGAGCG
AAAAAAAAAATAAGCCTGAAGGCT	ATTATGGTCCCTCACG
AAAAAAAAACCCGGAACGCAATTG	ATTCAACCAACCCTAA
AAAAAAAATGAAGCCACGCAATTG	ATTCAACCAAGCTACC
AAAAAAAACAACATAACGCAATTG	ATTCAACCAGGAACCA
AAAAAAAAACCTGCTACGCAATTG	ATTCAACCATTGCGAC
AAAAAAAATAGGTAGCTAAGCGCA	ATTCACTTCTAATCTC
AAAAAAAAATTTCGCGATAACGAC	ATTCATGAGCAAGGAC
AAAAAAAAGAGAAACGATAACGAC	ATTCATGAGGAAACTG
AAAAAAAAGTTAGGCGAACAGGAA	ATTCCGGAGCAGGTTT
AAAAAAAAATGAGGAGAACAGGAA	ATTCCGGAGCATTATG
AAAAAAAACCAATACTGGGATAAC	ATTCCTAGTATGGTGC
AAAAAAAAGCTCCCTTGGGATAAC	ATTCCTAGTCTCACTG
AAAAAAAAGGGAACCTGGGATAAC	ATTCCTAGTGGATTCA
AAAAAAAATAGACAATGGGATAAC	ATTCCTAGTTAAATGC
AAAAAAAACCCAATTACCTCATTG	ATTCCTCCACCATATG
AAAAAAAACGCTAAGACCTCATTG	ATTCCTCCAGAATGAC
AAAAAAAAGTTGTCCACCTCATTG	ATTCCTCCAGCGCTTG
AAAAAAAAAGACCATACCTCATTG	ATTCCTCCAGCTAACC
AAAAAAAAGTCCTAACTGAGCGAT	ATTCGTTTCCCATAAA
AAAAAAAACTAGATTCTGAGCGAT	ATTCGTTTCCGGGACT
AAAAAAAACTGTTACACGCGAACC	ATTGAAGCAACAGGTG
AAAAAAAAGGCCAGTACGCGAACC	ATTGAAGCACCAACCG
AAAAAAAACGAATATACGCGAACC	ATTGAAGCACCTGCCT
AAAAAAAATCCAGGAACGCGAACC	ATTGAAGCATCACAGC
AAAAAAAATGCACTTACCGTTAAA	ATTGACTCAGAGGCTA
AAAAAAAACGATTAAACCGTTAAA	ATTGACTCATTGTCAG
AAAAAAAAAACCTAAGACAGCTAA	ATTGCACAGAATCTCA
AAAAAAAAAGGGTGGGACAGCTAA	ATTGCACAGAATGACG
AAAAAAAAACTGAGCGACAGCTAA	ATTGCACAGCTAAAGG
AAAAAAAACACATACTGCAACCCG	ATTGCAGGTGCAACTA
AAAAAAAAAGCTTGCTGCAACCCG	ATTGCAGGTTTAGCTC
AAAAAAAAAGTCACAACCTAACTC	ATTGCGCCAAATATCC
AAAAAAAAGGAAGCAACCTAACTC	ATTGCGCCACTAAGTT
AAAAAAAACTAACCTACCTAACTC	ATTGCGCCATGATTGT
AAAAAAAAGGTCCAAGACTTACAT	ATTGGCTAGCGCCTAA
AAAAAAAATGAGCGCGACTTACAT	ATTGGCTAGCTAATCA
AAAAAAAATGGCTAAGACTTACAT	ATTGGCTAGCTCCTAC
AAAAAAAATTCTTAGGACTTACAT	ATTGGCTAGCTGGAAA
AAAAAAAACTGCTGTGACTTACAT	ATTGGCTAGGGATGAC
AAAAAAAATGAGGAAACCGGATAC	ATTGGTTCAACACCTA
AAAAAAAAACCTTGCACCGGATAC	ATTGGTTCAAGCTTTG
AAAAAAAATGATTAGACCGGATAC	ATTGGTTCAGCAAGTG
AAAAAAAAACCGAATACCGGATAC	ATTGGTTCAGGACCAA
AAAAAAAATATGCTCACCGGATAC	ATTGGTTCAGGGAGCT
AAAAAAAAGCGCACAACCGGATAC	ATTGGTTCATCAGCAC
AAAAAAAACGAGCTAACCGGATAC	ATTGGTTCATGACTAT
AAAAAAAAGTCCTCCTGCATATCG	ATTGTCCGTCACAAAT
AAAAAAAAAGGTTCCTGCATATCG	ATTGTCCGTTAAGTGT
AAAAAAAACAGCTACCTTGTTGCG	ATTGTGATCCCGTTGT
AAAAAAAACTCGCACACGGATAAA	ATTTAGCCAAGTGTCC
AAAAAAAACCATTGTACGGATAAA	ATTTAGCCATAAGGAC
AAAAAAAAGTCTTGACTGGGACAT	ATTTAGGTCATGACCG
AAAAAAAAGGTCCAAGAGTTACTC	ATTTGCAAGCGCCTAA
AAAAAAAAACCAAATGAGTTACTC	ATTTGCAAGCTATTAG
AAAAAAAAATGCTTCGAGTTACTC	ATTTGCAAGCTCCTTA
AAAAAAAAGGCTAGCACTTAAAGC	ATTTGCGCAAGGTGGC
AAAAAAAATCCTCAAACTTAAAGC	ATTTGCGCATCAGTAT
AAAAAAAAGTACTTCGAGCCTTTA	ATTTGTGAGAGGATAT
AAAAAAAAGACGAGGGAGCCTTTA	ATTTGTGAGCATGTCG
AAAAAAAAGTGGCCAACAATTGGC	CAAACAACAAGTTATC
AAAAAAAAAGCACTAACAATTGGC	CAAACAACACCGTTCC
AAAAAAAAATAGTGACTAGTCTCA	CAAACACTCCGCATGA
AAAAAAAAATGTTGCCTAGTCTCA	CAAACACTCCGTCCAT
AAAAAAAATTGGGTTTGCTCACTC	CAAACATGTAACAGGG
AAAAAAAAAGGCGGTTGCTCACTC	CAAACATGTGATTACG
AAAAAAAAGCTTGTGTGCTCACTC	CAAACATGTTGAAGCC
AAAAAAAAGTTAGTTTGCTCACTC	CAAACATGTTGAGGTC
AAAAAAAAACCATTATGCTCACTC	CAAACATGTTTATCTG
AAAAAAAAACTAAAGCTATTAGCC	CAAACCGTCATTTGCT
AAAAAAAAGGTTACCTGGAACAAC	CAAACGCGTAGCCATA
AAAAAAAATGACAAATGGAACAAC	CAAACGCGTTTAACGG
AAAAAAAAACCACGTTGTGCGGAA	CAAACTGGTAATCACG
AAAAAAAATGGAGCATGTGCGGAA	CAAACTGGTCATTGAG
AAAAAAAACTGAAGGTGTGCGGAA	CAAACTGGTCCTAACT
AAAAAAAATGCGTGAACTAGTGAT	CAAAGCGCACATTAAC
AAAAAAAATTGCTCTCTAAAGGCC	CAAAGGATCACATTGA
AAAAAAAATTATAGCCTAAAGGCC	CAAAGGATCGTTATCT
AAAAAAAACTATTTGGATTCAATC	CAAAGTGAGATGCCTG
AAAAAAAAAGAGCAAGATTCAATC	CAAAGTGAGGAAGTAT
AAAAAAAACGGATTAGATTCAATC	CAAAGTGAGGTTACGT
AAAAAAAACGTAAAGCTGGATGCA	CAAATCATCAATGTCA
AAAAAAAACGGCAAGCTGGATGCA	CAAATCATCCAAATCA
AAAAAAAATCCACCTTGTAAACAG	CAACAATGTAAGGTTT
AAAAAAAAAGGCAATTGTAAACAG	CAACAATGTCATTGTC
AAAAAAAATGCTTCAACGCTTGAA	CAACAGGCAATAGCCC
AAAAAAAAGCTACTCACGCTTGAA	CAACAGGCACTGACCG
AAAAAAAAACCGAATACTATGTCC	CAACCCGCAGGACCAA
AAAAAAAATTGCTCTCTTTGACTA	CAACCCTTCACATTGA
AAAAAAAACTTGAGCCTTTGACTA	CAACCCTTCGGTTCCT
AAAAAAAATTTCGTCCTCATAGAG	CAACTAATCATGGCTG
AAAAAAAAAATAAGCCTCATAGAG	CAACTAATCCCTCACG
AAAAAAAATCAAATCCTCATAGAG	CAACTAATCCGGAACC
AAAAAAAAACAGAATCTCATAGAG	CAACTAATCGATATTG
AAAAAAAAACTAAGGTGCTTCTTA	CAACTAGGTATTACCC
AAAAAAAACTCCTCATGCTTCTTA	CAACTAGGTCACGAAC
AAAAAAAATGGAGCATGCTTCTTA	CAACTAGGTCATTGAG
AAAAAAAAGGTCCATTGCTTCTTA	CAACTAGGTCGTAATG
AAAAAAAATTACCTTTGCTTCTTA	CAACTAGGTGTCCAGG
AAAAAAAACGCTACGTGCTTCTTA	CAACTAGGTGTGCAAC
AAAAAAAAAACTGAGTGCTTCTTA	CAACTAGGTTGCTGGG
AAAAAAAATGCCTCGACACAAAGA	CAAGAACCAATAACCT
AAAAAAAACTAAGTAACACAAAGA	CAAGAACCAGCATGTC
AAAAAAAATTATCACGATTAGTGG	CAAGACAAGCATTAGC
AAAAAAAAGGCAGGTTGCAATAAG	CAAGCTAGTAACCTAG
AAAAAAAACATCATGTGCAATAAG	CAAGCTAGTCAGGCCA
AAAAAAAACGGAAACTGCAATAAG	CAAGCTAGTTAACGAT
AAAAAAAAGTCTTGACTGATAATG	CAAGGCCTCATGACCG
AAAAAAAAAAGTAACCTGATAATG	CAAGGCCTCTTGATGA
AAAAAAAACGTTATGTGGAGCATA	CAAGGCTGTAATCGTG
AAAAAAAACGCATTATGGAGCATA	CAAGGCTGTGGATTAT
AAAAAAAACAGTCTATGGAGCATA	CAAGGCTGTGTTTGAG
AAAAAAAACCACTAATGCGTACTA	CAAGGGAGTATTGTCC
AAAAAAAACTGACATTGCGTACTA	CAAGGGAGTTGGATAT
AAAAAAAAACATAACGAACAAGGA	CAAGGTAAGAACCTGT
AAAAAAAATCGTACCGAACAAGGA	CAAGGTAAGCCAAATC
AAAAAAAAACTGAGCGAACAAGGA	CAAGGTAAGCTAAAGG
AAAAAAAATCGTGCTGAACAAGGA	CAAGGTAAGTTGCCTC
AAAAAAAATCAATTGCTAGTAGGC	CAAGGTTTCTCCATAT
AAAAAAAAGGCACTGACCAAGTTA	CAAGTAACAAACTCAT
AAAAAAAAGCTAGTAACCAAGTTA	CAAGTAACACCTAATG
AAAAAAAAGTGGATTACCAAGTTA	CAAGTAACAGCAACAG
AAAAAAAAGTAGGTTACCAAGTTA	CAAGTAACAGGCGAGT
AAAAAAAAGCTTATTACCAAGTTA	CAAGTAACATAAAGCA
AAAAAAAATGTAACCTGTGACATC	CAAGTATGTTGCCTCA
AAAAAAAAGCGTCTATGTGACATC	CAAGTATGTTTGAGCA
AAAAAAAAACAACTAGAGAAACCC	CAAGTGAAGGAATAAC
AAAAAAAAGCTTAAAGAGAAACCC	CAAGTGAAGGCTACAT
AAAAAAAAGTACTGGGAGAAACCC	CAAGTGAAGTCTGGGC
AAAAAAAATACGTTACTCATCATA	CAAGTTATCAAACTCA
AAAAAAAAAGTGAATCTCATCATA	CAAGTTATCAAGCCTG
AAAAAAAATAGCTTACTCATCATA	CAAGTTATCAATCTAG
AAAAAAAATCTTGCTCTCATCATA	CAAGTTATCAGTTCCC
AAAAAAAACACTATACTCATCATA	CAAGTTATCTGGCATG
AAAAAAAATGTCCTTCTATCTGTG	CAATAGCTCTACTAAG
AAAAAAAAAGGTGCACTCTAGCCA	CAATATGTCAGGTTTA
AAAAAAAATCTTGCTCTCTAGCCA	CAATATGTCAGTTCCC
AAAAAAAAAATCCACCTCTAGCCA	CAATATGTCCCGAAGC
AAAAAAAAAGTCTTGCTTAGCTGC	CAATCCCTCAAGCTAC
AAAAAAAAGGTTTGTCTTAGCTGC	CAATCCCTCACGCCAA
AAAAAAAAGTGAGCACTTAGCTGC	CAATCCCTCATGTCAA
AAAAAAAATCGGTACCTTAGCTGC	CAATCCCTCCAGGAAA
AAAAAAAACGGAGCACTTAGCTGC	CAATCCCTCCTAGTAA
AAAAAAAAAGATTGACTTAGCTGC	CAATCCCTCCTCACTA
AAAAAAAACACTATACTTAGCTGC	CAATCCCTCTGGCATG
AAAAAAAATTACGGTTGGCTTGCA	CAATCCTGTTGCAATG
AAAAAAAAAAGGACTTGGCTTGCA	CAATCCTGTTGTGATG
AAAAAAAATGAATTGACAGATTCG	CAATCGCCAATAATGG
AAAAAAAACTTTAACGAGTAATTG	CAATCTAAGCTATATG
AAAAAAAAGTGCGTGACTCACTTG	CAATGAACAGGTCCTG
AAAAAAAACGGCCTTACTCACTTG	CAATGAACATAAGCAA
AAAAAAAACCTCGCAACTCACTTG	CAATGAACATGTCAAT
AAAAAAAACAACTCGCTATTGAGA	CAATGACTCAAATCGC
AAAAAAAATGTAGCCCTATTGAGA	CAATGACTCACAGCGC
AAAAAAAATTGACCGCTATTGAGA	CAATGACTCATGGTGT
AAAAAAAAATAGATGCTATTGAGA	CAATGACTCTACCTGC
AAAAAAAAACCCGGAACTAGTGCG	CAATGCCCAACCCTAA
AAAAAAAACTTAGAAACTAGTGCG	CAATGCCCAGCCTGCA
AAAAAAAAACAGCCAGAACGGTTG	CAATGTCAGCTAAGTC
AAAAAAAACTAGGCGGAACGGTTG	CAATGTCAGGGACTAA
AAAAAAAACAGGTCCTGAACGAAC	CACAAGCGTGAGGTAG
AAAAAAAAATGCTTATGAACGAAC	CACAAGCGTGCACGCA
AAAAAAAAACGGAACCTGTTGTTG	CACAATATCATCCACC
AAAAAAAACCGGTTACTGTGGGTA	CACAGGCTCCGTTAAA
AAAAAAAATAGGTAGCTGTGGGTA	CACAGGCTCTAATCTC
AAAAAAAATGTTGCGCTGTGGGTA	CACAGGCTCTAGCGTG
AAAAAAAACTAAGGACTGGTTCCG	CACATAATCATTATGG
AAAAAAAATCATGGAGAGCAATCG	CACATACAGACCATAC
AAAAAAAAGGATATTGAGCAATCG	CACATACAGCTGTACG
AAAAAAAACAGTTAGGAGCAATCG	CACATACAGTAAGTGG
AAAAAAAAGGTTAATGATAGCTAG	CACATTAAGAACCTAC
AAAAAAAAGAGTTGCGATAGCTAG	CACATTAAGATGGAGC
AAAAAAAAGGACCATGATAGCTAG	CACATTAAGCTCAATA
AAAAAAAACTTCCTTGATAGCTAG	CACATTAAGGCTATGT
AAAAAAAAATGGTTAGATAGCTAG	CACATTAAGGTTAGCT
AAAAAAAATAACGTGGATAGCTAG	CACATTAAGTCAATCA
AAAAAAAAACCCTCAACATGAAGA	CACCAACCAGCATTAT
AAAAAAAACTAGTAAACATGAAGA	CACCAACCAGTAAAGC
AAAAAAAATTAAAGCACATGAAGA	CACCAACCATAATCCG
AAAAAAAATGGTTAAACATGAAGA	CACCAACCATCTAGCA
AAAAAAAATCATGGAGATGGCTTC	CACCGGTAGACCATAC
AAAAAAAATCGTTATGATGGCTTC	CACCGGTAGTTTGGGT
AAAAAAAATGAACGGTGCACTTGA	CACCTCAGTTTCCGGC
AAAAAAAATTTGCTCCTTGTTGTA	CACCTGTTCATAGCCG
AAAAAAAATAGCCACCTTGTTGTA	CACCTGTTCGATTTGA
AAAAAAAAAGAAAGGCTTGTTGTA	CACCTGTTCTCACTCA
AAAAAAAAGGCTTCGCTCTCACAG	CACGCAATCCTAGTCC
AAAAAAAAATACAGGTGCAAGGGT	CACTAAGGTCAATGTG
AAAAAAAAACACCGTTGCAAGGGT	CACTAAGGTTATTGCC
AAAAAAAACATCGTTACTAACGGC	CACTAGCCAACATAAG
AAAAAAAAGATCATGACTACGGAC	CACTGACCAAAGCTCC
AAAAAAAATGATCAGGATCACACC	CACTTAAAGAATCGCT
AAAAAAAATGGTTAGGATCACACC	CACTTAAAGGAACCGG
AAAAAAAATGGGCGTGATCACACC	CACTTAAAGGCGAAAC
AAAAAAAACTAAAGCGATCACACC	CACTTAAAGTGTGATC
AAAAAAAAAATCCGGGATCACACC	CACTTAAAGTTAGACC
AAAAAAAACCGAAGCGATCACACC	CACTTAAAGTTTGGTA
AAAAAAAACGCTATGCTACCTCCT	CACTTTGTCCACCTTA
AAAAAAAAGTAGCAGCTACCTCCT	CACTTTGTCTTGTTCG
AAAAAAAACTGCCAGTGTGTGACT	CAGAACCGTAACGGGA
AAAAAAAACTTCGCTTGTGTGACT	CAGAACCGTTAGGATT
AAAAAAAAGGGTAATTGTGTGACT	CAGAACCGTTCAAGAT
AAAAAAAAAGCAATACTGTAACGG	CAGAATCTCAGCAAGA
AAAAAAAACCGGTTACTGTAACGG	CAGAATCTCCGTTAAA
AAAAAAAAGTAATGACTGTAACGG	CAGAATCTCGGTTTGG
AAAAAAAAGCTAAATGATACTTCA	CAGATTCAGATAACCC
AAAAAAAAAGGTTATGATACTTCA	CAGATTCAGGACCGCT
AAAAAAAAGTACTGGGATACTTCA	CAGATTCAGTCTGGGC
AAAAAAAATTTGTACGATACTTCA	CAGATTCAGTTGTCCC
AAAAAAAATGATCCTACAAGTAAG	CAGCAAGCACTGGCTG
AAAAAAAAAGGTTACACAAGTAAG	CAGCAAGCATCAATCG
AAAAAAAAAATAAGCCTCGAGCTT	CAGCATGTCCCTCACG
AAAAAAAAATTTGCGCTCGAGCTT	CAGCATGTCCTTTACG
AAAAAAAACCTGCTCCTCGAGCTT	CAGCATGTCTTGACCC
AAAAAAAAGGCTGATGACAAACAC	CAGCATTAGACAGGTA
AAAAAAAAATAGCTCCTAAATGAC	CAGCCAATCCTTAATC
AAAAAAAATCAATTGCTAAATGAC	CAGCCAATCTCCATAT
AAAAAAAAAGGCTGGTGCTCAACA	CAGCTAAGTCATAACG
AAAAAAAAGAACTGATGCTCAACA	CAGCTAAGTGATGATT
AAAAAAAATACAACCTGCTCAACA	CAGCTAAGTTTGTCTA
AAAAAAAACTGCTGTGAGCGATAC	CAGCTATAGGGATGAC
AAAAAAAAGCTCATTGAGCGATAC	CAGCTATAGGTAGCTT
AAAAAAAACTCAGGCTGGTTCACG	CAGGAAGGTAATCCCT
AAAAAAAATTCACTTTGGTTCACG	CAGGAAGGTTAGCCAA
AAAAAAAATACTTGCACCAACATA	CAGGACACATAATGTC
AAAAAAAAGAAAGGCACCAACATA	CAGGACACATCCAGGT
AAAAAAAAACGGTTTCTCTAGCTG	CAGGACCTCGTTAACA
AAAAAAAAGCGGTACACCCTGGTC	CAGGATGCATAGTCAT
AAAAAAAAGCCAGCAACCCTGGTC	CAGGATGCATCGCTTT
AAAAAAAAATTGGTGACCCTGGTC	CAGGATGCATTGTTGG
AAAAAAAAGACCTGCCTAACGGTG	CAGGCTATCTAGCGAT
AAAAAAAATTACTCCCTAACGGTG	CAGGCTATCTAGCTTT
AAAAAAAACCACTAATGGCTGCTA	CAGGCTGGTATTGTCC
AAAAAAAATGTTGGCCTTCCTTTG	CAGGGCTTCACTAGGT
AAAAAAAAGAAAGCCCTTCCTTTG	CAGGGCTTCAGGATGA
AAAAAAAAACCAATCCTTCCTTTG	CAGGGCTTCGCTTCTA
AAAAAAAATGTGATGGACCATTAT	CAGGTCCAGGCAATAG
AAAAAAAACTTAATCGACCATTAT	CAGGTCCAGGTTTGAC
AAAAAAAACACCAAAGACCTCAGT	CAGGTGGAGTCAATTG
AAAAAAAAGCCTCAATGGGACATA	CAGGTTAGTAACGTGC
AAAAAAAAGTTTGGCTGGGACATA	CAGGTTAGTGATCAGC
AAAAAAAAAGAGGCGGAGGAGGGT	CAGGTTTAGGCCTAAT
AAAAAAAAGGGTACTGAGGAGGGT	CAGGTTTAGGGATTAG
AAAAAAAAAACTAACGAGGAGGGT	CAGGTTTAGTCACGAT
AAAAAAAATTCGCGCACGTCAACA	CAGTACCCAAACCTAT
AAAAAAAAATTGTTCACGTCAACA	CAGTACCCAAGGTATA
AAAAAAAATAGAATCACGTCAACA	CAGTACCCAGTAATAG
AAAAAAAAGCAACGGTGACTTACA	CAGTATGGTATCTGGA
AAAAAAAAAGAAACCTGACTTACA	CAGTATGGTCATTAGG
AAAAAAAAACACCGTTGACTTACA	CAGTATGGTTATTGCC
AAAAAAAAAGGGACCTGAACAGGT	CATAACGGTAACGAGG
AAAAAAAAATTTGGTTGAACAGGT	CATAACGGTCAGTAAT
AAAAAAAAGACATCCTGAACAGGT	CATAACGGTCTAACAG
AAAAAAAAGGTTCACTGAACAGGT	CATAACGGTCTATCGT
AAAAAAAACTACCGGTGAACAGGT	CATAACGGTGTTAAAC
AAAAAAAACGCTAGCTGAACAGGT	CATAACGGTTGGTTAG
AAAAAAAAAGGGATTTGAACAGGT	CATAACGGTTGTAAAC
AAAAAAAACAGTAAGCTTGCATGC	CATAAGCTCACAGACT
AAAAAAAATTAGGTTCTTGCATGC	CATAAGCTCCTTCGTA
AAAAAAAAGGTTATCCTTGCATGC	CATAAGCTCGTTATAG
AAAAAAAAGCGGTACACAATACCG	CATAATCCATAGTCAT
AAAAAAAATAACCAAACAATACCG	CATAATCCATGTTGCA
AAAAAAAATAGCTTACTTTAACTG	CATAATGTCAATCTAG
AAAAAAAAAGCAAGCCTACTACGT	CATAGACTCACCATTT
AAAAAAAAGGTGTGACTACTACGT	CATAGACTCCAAGTGT
AAAAAAAAGTATTGCCTACTACGT	CATAGACTCGGTCAGC
AAAAAAAACATGATGGATCATGGA	CATAGCTAGGCCTTAG
AAAAAAAACGTATTTGATCATGGA	CATAGCTAGGGCTTAT
AAAAAAAATTGGCCACTTAAGTTC	CATAGGTTCCGGTTGA
AAAAAAAAAGAATCACTTAAGTTC	CATAGGTTCCTCCCTC
AAAAAAAAAGTCAAACTTAAGTTC	CATAGGTTCGACCTGA
AAAAAAAACGAGTTAGAAGGACAA	CATAGTCAGCACGATT
AAAAAAAACTTTAACGAAGGACAA	CATAGTCAGCTATATG
AAAAAAAACACATAAACGGTTGGC	CATATCGCATGAATCT
AAAAAAAAGTAACACACGTAGCTA	CATCAATCAAACAACA
AAAAAAAACCGTTTAACGTAGCTA	CATCAATCACTGACTA
AAAAAAAATGATTAGACGTAGCTA	CATCAATCAGCAAGTG
AAAAAAAATATAGTGACGTAGCTA	CATCAATCAGCTCAAC
AAAAAAAAGAGCTATACGTAGCTA	CATCAATCAGTACCGT
AAAAAAAACTAGTCTACGTAGCTA	CATCAATCAGTTTACG
AAAAAAAAGTGGTGCACGTAGCTA	CATCAATCATAAACCT
AAAAAAAACTGAGTGACGTAGCTA	CATCAATCATCCATCT
AAAAAAAAAGCCCTTACGTAGCTA	CATCAATCATTCAGCA
AAAAAAAAACCTTGCACCCTCACG	CATCACACAAGCTTTG
AAAAAAAAGCGCTAGACCCTCACG	CATCACACAAGGTACG
AAAAAAAACCAAGGTACCCTCACG	CATCACACACAGCCAT
AAAAAAAATATAGTGACCCTCACG	CATCACACAGCTCAAC
AAAAAAAATCGAAGCACCCTCACG	CATCACACATTGTGGC
AAAAAAAAGAACCTAACCGCCTGT	CATCAGCCAGCTTACA
AAAAAAAAAAGCCTAACTATTAGG	CATCATGCATATAACC
AAAAAAAAATCCGGGACTATTAGG	CATCATGCATCATGTG
AAAAAAAAGTCAATGACTATTAGG	CATCATGCATTGCGGT
AAAAAAAACGGGTAATGTTAGCTG	CATCCCAGTTAGGCTA
AAAAAAAATGCTCTCTGTTAGCTG	CATCCCAGTTGCTTCG
AAAAAAAACGTTATGTGCGCGGTT	CATCCTGGTAATCGTG
AAAAAAAAGTGCGAGTGCGCGGTT	CATCCTGGTATTGAGT
AAAAAAAACGCCAACTGCGCGGTT	CATCCTGGTCATTACC
AAAAAAAATTCACTTTGCGCGGTT	CATCCTGGTTAGCCAA
AAAAAAAAGCTACTCACTCAGTCT	CATCCTTCACTGACCG
AAAAAAAAAGGGTTGCTCGCTCAA	CATCGCTTCTATTGTC
AAAAAAAAGCCATGCCTCGCTCAA	CATCGCTTCTCACAAA
AAAAAAAACGCAACCTGTGGCTAT	CATGCAAGTAGCTGGT
AAAAAAAAGTTGACGGAGTTGCAG	CATGCATAGTTCCTGC
AAAAAAAACTCTAGCGACGGGCAT	CATGCGCAGGGCTAAA
AAAAAAAAACCACGTTGCCCGCAA	CATGCGGGTAATCACG
AAAAAAAATCCAGATTGCCCGCAA	CATGCGGGTTAAGCCA
AAAAAAAACCTTGTTCTGTATTGC	CATGGATTCATCCTCA
AAAAAAAATCCTCTACTGTATTGC	CATGGATTCGCACACA
AAAAAAAAGGTTTATTGGGTAATG	CATGGCGGTAGGTTGC
AAAAAAAACCACTAATGGGTAATG	CATGGCGGTATTGTCC
AAAAAAAAATGGCCTTGGGTAATG	CATGGCGGTTTATCGC
AAAAAAAACGCCTCTCTACCTGAT	CATTATCTCAGGAACA
AAAAAAAACGCTTAGCTACCTGAT	CATTATCTCCTTCTAG
AAAAAAAATAGGTTTCTACCTGAT	CATTATCTCGCTCACT
AAAAAAAATAAATCCCTACCTGAT	CATTATCTCTTGTCTG
AAAAAAAAGATTGCGGATGCAAAC	CATTATGAGTGAACAG
AAAAAAAAAAGTTAGCTAAGGATT	CATTCATTCAAACCGT
AAAAAAAACTAGACCCTAAGGATT	CATTCATTCTTAGCGG
AAAAAAAACGTAAATACAACAACC	CATTCCTCAGCTAATT
AAAAAAAAGAGAGCAACAACAACC	CATTCCTCAGGACCTT
AAAAAAAATATCCGCGAGGATGCT	CATTGCGAGATACTTG
AAAAAAAAAGAGCAAGAGGATGCT	CATTGCGAGGAAGTAT
AAAAAAAAGTAATGTGAGGATGCT	CATTGCGAGGAGGACT
AAAAAAAAACCCGGAACGTAACGT	CATTGTGCAACCCTAA
AAAAAAAACCGGTAAACGTAACGT	CATTGTGCAAGCCACT
AAAAAAAATGAACCGACGTAACGT	CATTGTGCACATACTG
AAAAAAAAGTGAGGAACGTAACGT	CATTGTGCACGTAATT
AAAAAAAAGTAGTCAACGTAACGT	CATTGTGCAGCACCAT
AAAAAAAATAGCTTACTCCCTTTA	CATTTGTTCAATCTAG
AAAAAAAACAACAAGCTCCCTTTA	CATTTGTTCCCTTGCG
AAAAAAAATCCAATACTCCCTTTA	CATTTGTTCTAATCAG
AAAAAAAAGGTAACTACTATTGGA	CCAAACCCAACAGGAT
AAAAAAAAGGGAGTAACTATTGGA	CCAAACCCAGCATGAG
AAAAAAAAGCTACAAACTATTGGA	CCAAACCCAGGCTACT
AAAAAAAACTAGTCTACTATTGGA	CCAAACCCAGTTTACG
AAAAAAAATAACTTCGAAATGCAT	CCAAACTAGCCTGGTA
AAAAAAAACTAGGCGGAAATGCAT	CCAAACTAGGGACTAA
AAAAAAAAATTTCGCGAGGTGCAT	CCAAATCAGCAAGGAC
AAAAAAAACATAGGTGAAACCGGT	CCAACATAGGCATGTT
AAAAAAAATCCGGTACTGCAAGTG	CCAAGGCTCAATCATG
AAAAAAAAAGAGAAGCTGCAAGTG	CCAAGGCTCGTCAAGT
AAAAAAAATCCCTTTGATATAGGC	CCAAGTTAGGCATTAC
AAAAAAAAGAGCGCTACGGGAAGT	CCAATATCAACCTGGT
AAAAAAAAATTGTTCACGGGAAGT	CCAATATCAAGGTATA
AAAAAAAACCACTTAACGGGAAGT	CCAATATCACATTGCA
AAAAAAAAGATTAGTGAACTGGCA	CCACAATAGCTTATGA
AAAAAAAAGTCACAGGAACTGGCA	CCACAATAGGACGTAA
AAAAAAAAGGAGGGTGAACTGGCA	CCACAATAGGGCCATC
AAAAAAAAGCTAACGGACATAGAC	CCACACAAGCTTAACA
AAAAAAAAGATTGCGGACATAGAC	CCACACAAGTGAACAG
AAAAAAAAAATCCGGGACATAGAC	CCACACAAGTTAGACC
AAAAAAAATTGTTGGTGTCAAACC	CCACAGGGTAGGTTTG
AAAAAAAATCGATCATGTCAAACC	CCACAGGGTCCACAAA
AAAAAAAAGCCATCATGGTCATGC	CCACATTGTAGTAAGA
AAAAAAAATCCACCTTGCACAGGA	CCACTTGGTAAGGTTT
AAAAAAAACCGATTATGCACAGGA	CCACTTGGTACCAGGT
AAAAAAAAAGGCTGGTGCACAGGA	CCACTTGGTCATAACG
AAAAAAAAGGGAACCTGCACAGGA	CCACTTGGTGGATTCA
AAAAAAAAGCGGTTGACGTCAATG	CCAGACTCAAGGAATC
AAAAAAAAAACCCTCACGTCAATG	CCAGACTCAATCTCTC
AAAAAAAATGATCCTACGTCAATG	CCAGACTCACTGGCTG
AAAAAAAATGTCAGGACGTCAATG	CCAGACTCAGGTTCAC
AAAAAAAAGTCCATCACGTCAATG	CCAGACTCATTCCTGT
AAAAAAAAGGATTAGTGGCTTTAA	CCAGCCTGTATTCGTC
AAAAAAAAAGAAACCTGGCTTTAA	CCAGCCTGTCATTAGG
AAAAAAAAGTTATTGTGGCTTTAA	CCAGCCTGTGGACCTG
AAAAAAAACTGCTAATGGCTTTAA	CCAGCCTGTTACAAAC
AAAAAAAAGGATTGATGGCTTTAA	CCAGCCTGTTTACTTG
AAAAAAAATTAGGACGAGTTAGCG	CCAGCTAAGGGTTATC
AAAAAAAATCCGCATGAGTTAGCG	CCAGCTAAGGTAACGA
AAAAAAAATGCTTATGAGTTAGCG	CCAGCTAAGTAAACCC
AAAAAAAATACGGGCGAGTTAGCG	CCAGCTAAGTATCGCG
AAAAAAAACATCGTTACAGGTTGT	CCAGCTGCAACATAAG
AAAAAAAACTCGAGCTGTTCAAGC	CCAGGATGTAACTACG
AAAAAAAAGGTTACCTGTTCAAGC	CCAGGATGTAGCCATA
AAAAAAAATTGTTGGTGTTCAAGC	CCAGGATGTAGGTTTG
AAAAAAAACAATGAATGTTCAAGC	CCAGGATGTGATGGCT
AAAAAAAACGATCCGTGTTCAAGC	CCAGGATGTTTAAAGC
AAAAAAAACCACTAATGAACCGTC	CCAGTTTGTATTGTCC
AAAAAAAAGCATAGATGAACCGTC	CCAGTTTGTGAGCAAG
AAAAAAAAGTCTAGCTGAACCGTC	CCAGTTTGTGGATGTC
AAAAAAAAGCCAGGATGAACCGTC	CCAGTTTGTTATCGAG
AAAAAAAAAGTCTTGCTAGGACCA	CCATAAATCAAGCTAC
AAAAAAAAACAAGCGCTAGGACCA	CCATAAATCAATAGCC
AAAAAAAACCTGCAACTAGGACCA	CCATAAATCATTGACA
AAAAAAAACCAATATCTAGGACCA	CCATAAATCCTAATGA
AAAAAAAAAAAGGTTCTAGGACCA	CCATAAATCGATCAGT
AAAAAAAAACGTAAACTAGGACCA	CCATAAATCGGTCAAT
AAAAAAAAGTAGCAGCTAGGACCA	CCATAAATCTTGTTCG
AAAAAAAACAGCATTTGCTATGAC	CCATAAGGTGAACAAA
AAAAAAAATCCAGATTGCTATGAC	CCATAAGGTTAAGCCA
AAAAAAAAATGGTCAACTTGGACG	CCATAATCAGTCTATG
AAAAAAAAAAGCCTAACTTGGACG	CCATAATCATATAACC
AAAAAAAACTGGGTAACTGCAAAT	CCATAGCCAAACTAAG
AAAAAAAATACAACAACTGCAAAT	CCATAGCCAACTAGCC
AAAAAAAACCATTGTACTGCAAAT	CCATAGCCATAAGGAC
AAAAAAAAAACGGACCTCCCTCTG	CCATATTTCCTAGTTT
AAAAAAAAACATTGCCTTGCGTGT	CCATCACTCAGAAACG
AAAAAAAACTATCGGCTTGCGTGT	CCATCACTCAGGGCCT
AAAAAAAAGTAGTAACTTGCGTGT	CCATCACTCCTACCTA
AAAAAAAACCTATGGCTTGCGTGT	CCATCACTCGGGACTC
AAAAAAAAGTTACCGTGACTCACG	CCATCATGTCCTAATC
AAAAAAAAAAGCTAGTGACTCACG	CCATCATGTTGCGCGA
AAAAAAAATATTCCTTGACTCACG	CCATCATGTTTGCAGA
AAAAAAAATAGAGATTGACTCACG	CCATCATGTTTGGCTT
AAAAAAAAGGTTACCTGTTAGACC	CCATTGTGTAGCCATA
AAAAAAAATTTATCCTGTTAGACC	CCATTGTGTCGCAAAC
AAAAAAAATCCGCACACCTTAACC	CCCAAACCAATCCTAG
AAAAAAAATTCCGGCACCTTAACC	CCCAAACCATATTGAC
AAAAAAAACTATTGTGAGATTCCT	CCCAAATAGACTAAGG
AAAAAAAAGTGATTAGAGATTCCT	CCCAAATAGGTCCGTA
AAAAAAAAGCCAACAGAGATTCCT	CCCAAATAGGTCTTGG
AAAAAAAAGAAGTGAGAGATTCCT	CCCAAATAGTGATTCA
AAAAAAAATGCTTCCTGCATGTCA	CCCAACCGTAGCAGCT
AAAAAAAACACTGGCTGCATGTCA	CCCAACCGTGGAAGGC
AAAAAAAATCCACCTTGTCGTTAG	CCCAATTGTAAGGTTT
AAAAAAAAAGGCCTTTGTCGTTAG	CCCAATTGTGTGTGGT
AAAAAAAATCCAGATTGTCGTTAG	CCCAATTGTTAAGCCA
AAAAAAAATTCCACCTGTCGTTAG	CCCAATTGTTGCACAA
AAAAAAAAATTGGGATGTCGTTAG	CCCAATTGTTGCGGAT
AAAAAAAACGCACCATGTCGTTAG	CCCAATTGTTGTGACA
AAAAAAAACGTGATGACACTGGGC	CCCAGCACAATGAATG
AAAAAAAATTACTGCACACTGGGC	CCCAGCACAGTATGTT
AAAAAAAATGGCATGACACTGGGC	CCCAGCACATAAGTCT
AAAAAAAACATAATCCTCGATTTA	CCCAGTTTCACGAATC
AAAAAAAACTACTAACTCGATTTA	CCCAGTTTCTGTTCAT
AAAAAAAACTTAACCACTTCCTCC	CCCGCAACAATTAGGA
AAAAAAAATGCCTCGACATGCTGA	CCCGCTTCAATAACCT
AAAAAAAAGTTTCCAGATCCTAAT	CCCGTAAAGCTGGCTA
AAAAAAAAGGAACATTGCTTGTCC	CCCTAATGTCCTAGTT
AAAAAAAATACCTCCTGCTTGTCC	CCCTAATGTTAGACCA
AAAAAAAATCCCTCTACTTGACTC	CCCTCACCAATCATGT
AAAAAAAATTTGCAACTGCTATGT	CCCTCAGTCAATGAGG
AAAAAAAAATGACAACTGCTATGT	CCCTCAGTCATGCCTC
AAAAAAAAAGCCGGTACGCTTGGG	CCCTGGACACAGACTC
AAAAAAAATGTTGTTGAGCCTTGC	CCCTGTTAGACAACAG
AAAAAAAACCTTTGGGAGCCTTGC	CCCTGTTAGAGAAGGG
AAAAAAAAAGTGTGCGAGCCTTGC	CCCTGTTAGCTTACTT
AAAAAAAACGCTTAGCTAGTAAAC	CCCTTAATCCTTCTAG
AAAAAAAAAACTAAGCTAGTAAAC	CCCTTAATCGGGATTT
AAAAAAAATCGCAACCTAGTAAAC	CCCTTAATCGTAATCA
AAAAAAAACCTGCTCCTAGTAAAC	CCCTTAATCTTGACCC
AAAAAAAAGTGATGATGCTGGTTA	CCGACAGGTAACCACA
AAAAAAAAGGGTTAATGCTGGTTA	CCGACAGGTTAGGTTG
AAAAAAAATATATCGCTCCTCACC	CCGCAAATCAGTATTG
AAAAAAAAATAGCTCCTCCTCACC	CCGCAAATCCTTAATC
AAAAAAAATTACGGTTGATTAGGG	CCGCAAGGTTGCAATG
AAAAAAAACTTAGCTACCCGGTTC	CCGCACACAAAGGTAC
AAAAAAAACCGTTTAACCCGGTTC	CCGCACACACTGACTA
AAAAAAAATTCCGGCACCCGGTTC	CCGCACACATATTGAC
AAAAAAAAGAGAAGCACCCGGTTC	CCGCACACATGTGGGA
AAAAAAAAATGAGAAACCTGAATA	CCGCCAACACAATACT
AAAAAAAACGAATATACCTGAATA	CCGCCAACACCTGCCT
AAAAAAAAAACTTGGACCTGAATA	CCGCCAACATGCTTAG
AAAAAAAATCATATCGAACCGAAC	CCGCTAAAGAAACTGG
AAAAAAAACGTTAGGACTCCTCTC	CCGCTAGCAAGCTTAT
AAAAAAAAGTTCAAGACTCCTCTC	CCGCTAGCACCGGTAT
AAAAAAAAACACCAAACTCCTCTC	CCGCTAGCAGGTTATT
AAAAAAAAGGTTAACACTCCTCTC	CCGCTAGCATTATGCG
AAAAAAAATAGCTCATGATTGATC	CCGCTTAGTAGCCTCC
AAAAAAAAGCCATCATGATTGATC	CCGCTTAGTAGTAAGA
AAAAAAAACAGATAATGGCCACAT	CCGGTAGGTAGGTTAT
AAAAAAAAACCCGCTGAAGATTCA	CCGGTTAAGCAAGGTA
AAAAAAAACTTAATCGAAGATTCA	CCGGTTAAGGTTTGAC
AAAAAAAAACGATTAGAAGATTCA	CCGGTTAAGTGAGCAA
AAAAAAAACCTTCAGGAAGATTCA	CCGGTTAAGTTATCCT
AAAAAAAAACGGTTCTGACCGCTA	CCGTGCTGTAGCTAAT
AAAAAAAAGCCAGGATGACCGCTA	CCGTGCTGTTATCGAG
AAAAAAAAGCTCAGGACTTAGGTA	CCGTTAACACTGGCCA
AAAAAAAACCCGGTTACTTAGGTA	CCGTTAACAGGCTTCG
AAAAAAAATTACTGCACTTAGGTA	CCGTTAACAGTATGTT
AAAAAAAAGATACTCCTAATTGCC	CCGTTACTCCGCAACA
AAAAAAAAGCGGATACTAATTGCC	CCGTTACTCCTTGAGG
AAAAAAAATCCCACCCTAATTGCC	CCGTTACTCTGGCAAT
AAAAAAAAAGTTAGGTGAGATTCT	CCGTTATGTATTTGCC
AAAAAAAAGGTTCACTGAGATTCT	CCGTTATGTCTATCGT
AAAAAAAAATCGTGCTGAGATTCT	CCGTTATGTGGATTGC
AAAAAAAATTACGGTTGAGATTCT	CCGTTATGTTGCAATG
AAAAAAAATTCCACCTGAGATTCT	CCGTTATGTTGCACAA
AAAAAAAATGTAACCTGGTGAACA	CCGTTGCGTTGCCTCA
AAAAAAAAGATTGAGTGCCAGTAT	CCTAAAGGTACAATGT
AAAAAAAACGGACAATGCCAGTAT	CCTAAAGGTTAAGGTT
AAAAAAAAATGGCCTTGCCAGTAT	CCTAAAGGTTTATCGC
AAAAAAAAGCAACTAACCTAGCGA	CCTAAATCAACTAGGG
AAAAAAAACGGCCTTACCTAGCGA	CCTAAATCATAAGCAA
AAAAAAAATAAAGCTACCTAGCGA	CCTAAATCATAGCGGA
AAAAAAAAGAATCACACCTAGCGA	CCTAAATCATTGCGTA
AAAAAAAAGTGGCCAACCGTTCCG	CCTAAGCCAAGTTATC
AAAAAAAACGCTATGCTTCATTAG	CCTAAGGTCCACCTTA
AAAAAAAATTCGCGACTTCATTAG	CCTAAGGTCTGTAATG
AAAAAAAAAGATAACCTTCATTAG	CCTAAGGTCTTAAGTG
AAAAAAAACGAACTAGATTGCGGG	CCTAAGTAGGAGCACG
AAAAAAAAAGTTTGAGACAGAATC	CCTAATAAGTAACCAC
AAAAAAAATCGTGCTGACAGAATC	CCTAATAAGTTGCCTC
AAAAAAAAAGTCATTTGACATGCC	CCTAATCGTATGTGGC
AAAAAAAATGCTTAGTGAGCCGGA	CCTACTGGTCAACAAT
AAAAAAAAACCCTCCTGAGCCGGA	CCTACTGGTGGAAACG
AAAAAAAAAAATCCTTGAGCCGGA	CCTACTGGTGTTTCAC
AAAAAAAAGCGTTTGTGAGCCGGA	CCTACTGGTGTTTGTC
AAAAAAAAAACTGAGTGAGCCGGA	CCTACTGGTTGCTGGG
AAAAAAAATCGGTATTGAGCCGGA	CCTACTGGTTTAGTCC
AAAAAAAATCCCATAACAGGTTTG	CCTACTTCAGAAATGC
AAAAAAAATAAATGCACAGGTTTG	CCTACTTCAGGCCATT
AAAAAAAATCAATCCACAGGTTTG	CCTACTTCAGGCGATA
AAAAAAAATTACTGCACAGGTTTG	CCTACTTCAGTATGTT
AAAAAAAAGAGAAGCACAGGTTTG	CCTACTTCATGTGGGA
AAAAAAAAAGTTAGGTGCCCGTAG	CCTAGTTGTATTTGCC
AAAAAAAACAGCGCTTGCCCGTAG	CCTAGTTGTGTAATAC
AAAAAAAATGGATTAACGCCTTTG	CCTATAGCACCTGGTG
AAAAAAAATAGTAACACGCCTTTG	CCTATAGCAGTTTGTG
AAAAAAAACGACAGGCTAGTTACC	CCTATATTCAAGCGCC
AAAAAAAAGCCAGCTCTAGTTACC	CCTATATTCCAGGTCA
AAAAAAAATTCATGACTAGTTACC	CCTATATTCGGTTAGT
AAAAAAAAGACAAGCCTAGTTACC	CCTATATTCTCAATGA
AAAAAAAAGCAAATACTAGTTACC	CCTATATTCTCGACCT
AAAAAAAAGGCTAAGCTGTAATGA	CCTATTGTCATCAGTA
AAAAAAAACTAACTACTGTAATGA	CCTATTGTCCTGATGG
AAAAAAAACGCTTAGCTGTAATGA	CCTATTGTCCTTCTAG
AAAAAAAACACCCTCCTGTAATGA	CCTATTGTCTAGCTAA
AAAAAAAATATTAGCCTGTAATGA	CCTATTGTCTATCGCC
AAAAAAAACCATCACGAAACATTG	CCTATTTAGCTACTGG
AAAAAAAATGGGCGTGAAACATTG	CCTATTTAGGCGAAAC
AAAAAAAAGCTTAAAGAAACATTG	CCTATTTAGGCTACAT
AAAAAAAATCCGGTTGAAACATTG	CCTATTTAGTGCTGTG
AAAAAAAATCATGAGGAAACATTG	CCTATTTAGTTTGTCT
AAAAAAAAAGCTCAAACCTAAGCG	CCTCAAACATCGCTCC
AAAAAAAATTAATGGACCTAAGCG	CCTCAAACATTAGCCA
AAAAAAAATAAACCAACCTAAGCG	CCTCAAACATTGCAGC
AAAAAAAAAGAATCGTGGCTGTTG	CCTCAATGTACCGGAT
AAAAAAAATGCTATGTGGCTGTTG	CCTCAATGTTTGGGTA
AAAAAAAATTAGGAGCTATGGCCC	CCTCAGTTCACGTTAA
AAAAAAAAAACGGACCTATGGCCC	CCTCAGTTCCTAGTTT
AAAAAAAAGCGACTCCTATGGCCC	CCTCAGTTCGCTATGG
AAAAAAAACGTGAAACTTCGCGAT	CCTCCTCTCAAGGACA
AAAAAAAATTGAAGGCTTCGCGAT	CCTCCTCTCGCCTGTT
AAAAAAAAAGTTACAGATTAAGCG	CCTCCTGAGCTAGAAG
AAAAAAAAGCCGATAGATTAAGCG	CCTCCTGAGTAACGAG
AAAAAAAACACCAGGGATTCACCG	CCTGAATAGTAACTCA
AAAAAAAAACATTAGGATTCACCG	CCTGAATAGTTCCCGT
AAAAAAAAAGCACTAACTCATGCT	CCTGAGTCACCGTTCC
AAAAAAAAAGGTTACACTCATGCT	CCTGAGTCATCAATCG
AAAAAAAATCGTACCGAAACTGGC	CCTGATGAGCCAAATC
AAAAAAAAATTGCTCGAAACTGGC	CCTGATGAGCCATCAG
AAAAAAAACAGGAGGACGGGTTTA	CCTGCTCCAAGGGTTG
AAAAAAAATGATCCTACGGGTTTA	CCTGCTCCACTGGCTG
AAAAAAAACTTAGAAACAACTAGC	CCTGGATCAGCCTGCA
AAAAAAAACCTCCTCGATGAATGC	CCTGGTAAGGACAATG
AAAAAAAAAGGATTTGATGAATGC	CCTGGTAAGTTTGAGC
AAAAAAAAAAACCGTACTCCTAAC	CCTGTAACAGCCAGTT
AAAAAAAAGTCAATGACTCCTAAC	CCTGTAACATTGCGGT
AAAAAAAACTGGTTATGCGACACC	CCTGTATGTGCTGTAA
AAAAAAAAATGCTATTGCGACACC	CCTGTATGTTAGTTGG
AAAAAAAAGGGTAATTGCGACACC	CCTGTATGTTCAAGAT
AAAAAAAAAGACTAGTGCGACACC	CCTGTATGTTGGCGTG
AAAAAAAAGCTGGTTTGCTCAAAC	CCTGTTGGTACTGAAT
AAAAAAAAACGGTTCTGCTCAAAC	CCTGTTGGTAGCTAAT
AAAAAAAAGACGTAATGCTCAAAC	CCTGTTGGTTCCTGAT
AAAAAAAACGTGCTGTGCTCAAAC	CCTGTTGGTTTAGCGA
AAAAAAAATTGCATGTGCTCAAAC	CCTGTTGGTTTGGTTC
AAAAAAAACGACTTATGCTTGAAC	CCTTAACGTCCTTCAG
AAAAAAAATCCAGATTGCTTGAAC	CCTTAACGTTAAGCCA
AAAAAAAAGTAACACACAGATAGA	CCTTACTCAAACAACA
AAAAAAAATCGCTATACAGATAGA	CCTTACTCAATGAAGC
AAAAAAAATATGACAACAGATAGA	CCTTACTCAATTATGC
AAAAAAAAACTATGTTGGTCCACA	CCTTAGTGTACTTCAC
AAAAAAAACTTAATGCTTGATTTG	CCTTATGTCTTAGGGT
AAAAAAAAACGCGAACTCCTTAGG	CCTTCAATCGAGGAGT
AAAAAAAAGCTATTGCTCCTTAGG	CCTTCAATCTAAGTGC
AAAAAAAAGCTATGTCTCCTTAGG	CCTTCAATCTTTGAGA
AAAAAAAACGCAACCTGCGCTTAA	CCTTCAGGTAGCTGGT
AAAAAAAAAGCTACCTGCGCTTAA	CCTTCAGGTGGTTCCC
AAAAAAAAGCACCTATGCGCTTAA	CCTTCAGGTGTCCTGC
AAAAAAAAAGCCAGGTGCGCTTAA	CCTTCAGGTTTGCGAA
AAAAAAAACCTAAGCCTGCATCTA	CCTTCGGTCTAACCAA
AAAAAAAACCATTATGATCTTTGA	CCTTCGTAGATAGACG
AAAAAAAAGTAATTGGATCTTTGA	CCTTCGTAGGCGCTTA
AAAAAAAATCTCAATGATCTTTGA	CCTTCGTAGGTCATTA
AAAAAAAACCACAAAGATCTTTGA	CCTTCGTAGTTGGGCC
AAAAAAAAGTGTTTGCTTTCAGTA	CCTTGCGTCACCAATA
AAAAAAAACAGGAGGACGGTTTAG	CCTTGTTCAAGGGTTG
AAAAAAAATGGTTAAACGGTTTAG	CCTTGTTCATCTAGCA
AAAAAAAAAAGTTAGCTCAGTATT	CCTTTAGTCAAACCGT
AAAAAAAAGGCGATACTCAGTATT	CCTTTAGTCATCCTAT
AAAAAAAAGTAGTAACTCAGTATT	CCTTTAGTCCTACCTA
AAAAAAAAGAGGGTGGATTGTTTG	CGAAATGAGGGACGCA
AAAAAAAACGATCCTGATTGTTTG	CGAAATGAGTGAGGTA
AAAAAAAACCACTTGGAACCGTTT	CGAACAAAGCAACATC
AAAAAAAACTAGGCGGAACCGTTT	CGAACAAAGGGACTAA
AAAAAAAAGTAGCTGGAACCGTTT	CGAACAAAGGGTTAGA
AAAAAAAAGATTGCGGAACCGTTT	CGAACAAAGTGAACAG
AAAAAAAAGAGTCAATGGCCAATC	CGAACCGGTCACGGAT
AAAAAAAAAGCTTGTCTTTAACGT	CGAAGAATCATTCATC
AAAAAAAATTTAGTGCTTTAACGT	CGAAGAATCTAAGTCA
AAAAAAAAGTACTTCGAAGTAAGG	CGAAGCGAGAGGATAT
AAAAAAAATCTTAGTGAAACAATC	CGAAGTAAGCAATAGG
AAAAAAAAACAACTAGAAACAATC	CGAAGTAAGGAATAAC
AAAAAAAAACCCAACTGTACCTTT	CGAATATGTAATTAGC
AAAAAAAAGGAGGGTGATTAGGTG	CGAATCTAGGGCCATC
AAAAAAAATCAGGACACTAACTGA	CGACAAGCAATAGTCT
AAAAAAAACCGTTGCACTAACTGA	CGACAAGCACGGTACT
AAAAAAAATTGTTGCACTAACTGA	CGACAAGCAGAGGGAG
AAAAAAAACTAGTCTACTAACTGA	CGACAAGCAGTTTACG
AAAAAAAATCCGCACACGATAGAA	CGACCTGCAATCCTAG
AAAAAAAACCGGATAACGATAGAA	CGACCTGCATGAATAG
AAAAAAAAAGCACCTTGAGCATAG	CGACTAAGTGCTTAGA
AAAAAAAAATAACGGTGAGCATAG	CGACTAAGTGTTGCAA
AAAAAAAACTGCTAATGAGCATAG	CGACTAAGTTACAAAC
AAAAAAAACCATCCTTGAGCATAG	CGACTAAGTTAGAGGG
AAAAAAAAAGCGCATGACGCCTAT	CGAGCGAAGCAACAAG
AAAAAAAAAATCCCTGACGCCTAT	CGAGCGAAGGCTCATG
AAAAAAAATCCACCTTGCTCTCAC	CGAGCTGGTAAGGTTT
AAAAAAAAGTCCTGATGAAGGCTA	CGAGGAAGTCACCTAT
AAAAAAAAGGCATGGTGAAGGCTA	CGAGGAAGTCATAGAT
AAAAAAAAGCTCATTGACTTAGTT	CGAGGCAAGGTAGCTT
AAAAAAAATTGCATCACTAAGTAC	CGATATTCAAGTGTTT
AAAAAAAACTTCGTAACTAAGTAC	CGATATTCACAACAAA
AAAAAAAAACTGCAAACTAAGTAC	CGATATTCAGTTATGT
AAAAAAAACTAACCTACTAAGTAC	CGATATTCATGATTGT
AAAAAAAACCTGCTCCTTATTGAC	CGATCCTTCTTGACCC
AAAAAAAAGACTCAAACACGGACC	CGATGTCCAATTTGGT
AAAAAAAAAACAGCTACACGGACC	CGATGTCCAGAGAGCC
AAAAAAAACTTCCTCACACGGACC	CGATGTCCAGGATAAC
AAAAAAAAAACCCTCACGTCCAGG	CGATTATCAATCTCTC
AAAAAAAAGTGCGTGACGTCCAGG	CGATTATCAGGTCCTG
AAAAAAAATGGGAGGACGTCCAGG	CGATTATCATAACGGG
AAAAAAAAAGGCCCAACGTCCAGG	CGATTATCATGCAACC
AAAAAAAAAGAGCTGCTAACGAGC	CGATTCCTCAAGTGAG
AAAAAAAATTTGCAACTAACGAGC	CGATTCCTCAATGAGG
AAAAAAAATTGCCAGCTAACGAGC	CGATTCCTCGCTAAGT
AAAAAAAAACTAAGACTAACGAGC	CGATTCCTCTTAGCCC
AAAAAAAAATGGCCTTGTATTGGC	CGATTGAGTTTATCGC
AAAAAAAATCGTGACCTGCCAGAA	CGCAAATTCCTAATAG
AAAAAAAAACAGAATCTGCCAGAA	CGCAAATTCGATATTG
AAAAAAAACTCGAGCTGCGGTACC	CGCAATAGTAACTACG
AAAAAAAAACCACGTTGCGGTACC	CGCAATAGTAATCACG
AAAAAAAACAGGAACTGCGGTACC	CGCAATAGTACTGATG
AAAAAAAACGGGTAATGCGGTACC	CGCAATAGTTAGGCTA
AAAAAAAAATCGCGCCTTCAATCA	CGCAATGTCACCTGCT
AAAAAAAAGATATAGCTTCAATCA	CGCAATGTCATTAGCA
AAAAAAAAACGCGAACTTCAATCA	CGCAATGTCGAGGAGT
AAAAAAAATACGTTACTAGTGACG	CGCACAATCAAACTCA
AAAAAAAATGGTTATCTAGTGACG	CGCACAATCCTAAATG
AAAAAAAAATGTGCGGAAATGACT	CGCACACAGCCTGTGA
AAAAAAAAGACTAATGAAATGACT	CGCACACAGGCTAAGA
AAAAAAAATATCTGTGAAATGACT	CGCACACAGTACTGGT
AAAAAAAACTATACTGAAATGACT	CGCACACAGTTGGATC
AAAAAAAAGGTTGCGACGGTTTGA	CGCACCACACCCACAG
AAAAAAAACTTCCTTGATACTTGT	CGCATATAGGCTATGT
AAAAAAAAGATTTGAGATACTTGT	CGCATATAGGGTCTAT
AAAAAAAACTATCGCGATACTTGT	CGCATATAGTCACTCC
AAAAAAAATGCGCTTGATACTTGT	CGCATATAGTTTAACG
AAAAAAAATCTTGCTCTAAGTGGC	CGCATGATCAGTTCCC
AAAAAAAACTCTATGACAAAGAAC	CGCATTACACACCAAC
AAAAAAAATAAAGCTACAAAGAAC	CGCATTACATAGCGGA
AAAAAAAAAGTCATTTGCTGTGAT	CGCATTTGTATGTGGC
AAAAAAAATCCTCTACTTTGACCG	CGCCTCATCGCACACA
AAAAAAAATTATAGCCTTTGACCG	CGCCTCATCGTTATCT
AAAAAAAATACCTGATGATGTTGT	CGCCTGTGTCCGTAGG
AAAAAAAATTCACTTTGATGTTGT	CGCCTGTGTTAGCCAA
AAAAAAAAACATGTTTGATGTTGT	CGCCTGTGTTCCTGTG
AAAAAAAAGCAGTTAACAACAGCT	CGCGATTCAACTAGAA
AAAAAAAACTGAGCAACAACAGCT	CGCGATTCAGTAGCCT
AAAAAAAATGGCATGACAACAGCT	CGCGATTCATAAGTCT
AAAAAAAACTCAAGGACAACAGCT	CGCGATTCATTAGGTT
AAAAAAAAACGTAAACTTGCCTTT	CGCGGATTCGGTCAAT
AAAAAAAATGCAACAGAGCCACAA	CGCTAATAGAGGCTAA
AAAAAAAATCTCAATGAGCCACAA	CGCTAATAGGTCATTA
AAAAAAAATTGGCCACTTAGAGGT	CGCTACTTCCGGTTGA
AAAAAAAAGTGAAGCCTTAGAGGT	CGCTACTTCCTAAGGT
AAAAAAAATACCGCACTTAGAGGT	CGCTACTTCTTGTCCA
AAAAAAAACAGGATCACTGATCAA	CGCTCAGCATCTTGAG
AAAAAAAATCCGGTACTTCGCTCC	CGCTCCATCAATCATG
AAAAAAAACTATAACCTTCGCTCC	CGCTCCATCATTGCAA
AAAAAAAACTTAATGCTTCGCTCC	CGCTCCATCTTAGGGT
AAAAAAAACTGTTACACTAGGTTA	CGCTTAACAACAGGTG
AAAAAAAACCAGCAAACTAGGTTA	CGCTTAACACCAGGTT
AAAAAAAAATGGTCAACTAGGTTA	CGCTTAACAGTCTATG
AAAAAAAACGAGCTAACTAGGTTA	CGCTTAACATGACTAT
AAAAAAAAGACTAGGCTAGATTCC	CGCTTACTCCCGCCTA
AAAAAAAATTCATGACTAGATTCC	CGCTTACTCGGTTAGT
AAAAAAAAACTGCGCCTAGATTCC	CGCTTACTCGTAACGT
AAAAAAAAAGGGTTGCTAGATTCC	CGCTTACTCTATTGTC
AAAAAAAATGGGCGTGATCCGTCA	CGCTTCTAGGCGAAAC
AAAAAAAAGCCGATAGATCCGTCA	CGCTTCTAGTAACGAG
AAAAAAAATCGATCATGAAGGCCG	CGCTTGCGTCCACAAA
AAAAAAAAAGCGAGCTGACCAGGG	CGGAATCGTTTGTTGC
AAAAAAAATCGATTTGAGGCCTAA	CGGACCTAGCGAAGTA
AAAAAAAATGTATTGCTTGTGTGC	CGGAGTCTCATCACTT
AAAAAAAAAGAGGATGAGTAATGT	CGGATAAAGCATGGTT
AAAAAAAATTGGTTTGAGTAATGT	CGGATAAAGCCTAATA
AAAAAAAAATTAGTGGAGTAATGT	CGGATAAAGGACCTTG
AAAAAAAAGGCAATATGTTGTCCC	CGGATTAGTAGGATTT
AAAAAAAATGTTGCATGTTGTCCC	CGGATTAGTCAAAGGG
AAAAAAAAGAATGCATGAATATCC	CGGCAATGTTAGCATG
AAAAAAAACTGTTACACACCTTGC	CGGCTCACAACAGGTG
AAAAAAAAGCTAAATGATTACGCC	CGGGACAAGATAACCC
AAAAAAAAATGGATTGAGGGTGGA	CGGGCTTAGGCCCAGT
AAAAAAAAAAGCTTAGAGGGTGGA	CGGGCTTAGTTAGAGG
AAAAAAAATTGGGTTTGATTATGC	CGGGTATGTAACAGGG
AAAAAAAATTCCCGTTGATTATGC	CGGGTATGTAATCGCA
AAAAAAAAGGTTCACTGATTATGC	CGGGTATGTCTATCGT
AAAAAAAAGATTATCTGATTATGC	CGGGTATGTTACAACG
AAAAAAAAACCCGCTGAGTGAGTC	CGGGTCTAGCAAGGTA
AAAAAAAACGCGAAATGCTTGCAA	CGGTAACGTACCTTAC
AAAAAAAACCCAGCATGCTTGCAA	CGGTAACGTTAATGAC
AAAAAAAATCCGTAATGCTTGCAA	CGGTAACGTTCACCAT
AAAAAAAAGCTACAAACACCTACC	CGGTGAACAGGCTACT
AAAAAAAAACCGGACACACCTACC	CGGTGAACATTAGGCC
AAAAAAAAGTCAAGCGATAAAGGA	CGGTGAGAGACTTATG
AAAAAAAATATCCGCGATAAAGGA	CGGTGAGAGATACTTG
AAAAAAAACTGGCTTGAGACTAAT	CGGTTATAGATTGAGG
AAAAAAAAAGAGGGATGGTTAGTT	CGGTTCCGTAAGCACC
AAAAAAAAGCCTCTCTGGTTAGTT	CGGTTCCGTCCTCCAA
AAAAAAAAGGAACATTGCATGCTA	CGGTTGGGTCCTAGTT
AAAAAAAAGGAGAAACTGAGGTAC	CGGTTTCTCGGTTTCC
AAAAAAAATCCCTCTACACAAGCT	CGTAACCCAATCATGT
AAAAAAAAGGTACGCACACAAGCT	CGTAACCCACTTCACT
AAAAAAAACCTCGCAACACAAGCT	CGTAACCCATGTCAAT
AAAAAAAATTGAAGCGATGTTGCC	CGTAACTAGTAACAGG
AAAAAAAATCATCATGATGTTGCC	CGTAACTAGTCATTGA
AAAAAAAACCACTAATGTCCATTT	CGTAATGGTATTGTCC
AAAAAAAATTCTATCTGTCCATTT	CGTAATGGTTGGGTTA
AAAAAAAAGCAACGGTGTTGTAGC	CGTACGGGTATCTGGA
AAAAAAAATAATCCGTGTTGTAGC	CGTACGGGTTAACAGT
AAAAAAAACCTAGCGTGTTGTAGC	CGTACGGGTTAGGACC
AAAAAAAAGTTAGGCGAGGCCTTC	CGTAGTTAGCAGGTTT
AAAAAAAACCTAGCTGAGGCCTTC	CGTAGTTAGGCATGAA
AAAAAAAAGACCTAGGAGGCCTTC	CGTAGTTAGTAAGTCC
AAAAAAAATTCGCGCACAAGCCAT	CGTATTGCAAACCTAT
AAAAAAAATGAACCGACAAGCCAT	CGTATTGCACATACTG
AAAAAAAACTTACTGACAAGCCAT	CGTATTGCAGCACGTT
AAAAAAAAAATCGTGACAAGCCAT	CGTATTGCAGTTTCTC
AAAAAAAATATCCTAGATGGACCG	CGTCAATAGACTCGCA
AAAAAAAAAGAGCAAGATGGACCG	CGTCAATAGGAAGTAT
AAAAAAAAAGCAATTGATGGACCG	CGTCAATAGTCTATGA
AAAAAAAAGATTGCGGATGGACCG	CGTCAATAGTGAACAG
AAAAAAAAAATCACAGATGGACCG	CGTCAATAGTTATGGC
AAAAAAAATGTTGCATGTAATGCC	CGTCATTGTCAAAGGG
AAAAAAAACTGAAGGTGTAATGCC	CGTCATTGTCCTAACT
AAAAAAAAGTGCACTTGTAATGCC	CGTCATTGTGCTGGTG
AAAAAAAAAAGCATGTGCTCCGGA	CGTCCTAGTTTGGCGG
AAAAAAAAAGATAACCTTAACGTT	CGTGACATCTTAAGTG
AAAAAAAAGTAATGTGAGGTAATT	CGTGAGGAGGAGGACT
AAAAAAAACGTAGTAGAGGTAATT	CGTGAGGAGGATAAAC
AAAAAAAATGACAACGAGGTAATT	CGTGAGGAGTACCGCA
AAAAAAAATCATCATGAGGTAATT	CGTGAGGAGTCATTGA
AAAAAAAAGTAGGTGCTGCTGTGC	CGTGCTTTCATGCATA
AAAAAAAACTGGATCCTGCTGTGC	CGTGCTTTCCTCATCA
AAAAAAAAGACCTGCCTGCTGTGC	CGTGCTTTCTAGCGAT
AAAAAAAAAGAACCGCTGCTGTGC	CGTGCTTTCTCACACC
AAAAAAAAAAATCGCACTATTGAG	CGTGGTTCAGGAAGCC
AAAAAAAATAGAATCACTATTGAG	CGTGGTTCAGTAATAG
AAAAAAAATGTTGGCCTCACCAAC	CGTTAAATCACTAGGT
AAAAAAAACGGGAACCTCACCAAC	CGTTAAATCAGCCAAT
AAAAAAAACCTTACGGACAATACG	CGTTAGTAGGAGCATA
AAAAAAAAGCGAGAGGACAATACG	CGTTAGTAGGTTACAC
AAAAAAAACACTAAGGACAATACG	CGTTAGTAGTTCCTCA
AAAAAAAATGCGCTTGACAATACG	CGTTAGTAGTTTAACG
AAAAAAAATGCTTCCTGAGGCAAT	CGTTATCGTAGCAGCT
AAAAAAAACTACCGGTGAGGCAAT	CGTTATCGTGTTAAAC
AAAAAAAACACCATATGAGGCAAT	CGTTATCGTTTATTCG
AAAAAAAAGGTCATGGAGCAAGGG	CGTTGCAAGGACTAAG
AAAAAAAAGAGGAACACATTACCT	CGTTTCTCACCACAAC
AAAAAAAAGCGTGACACATTACCT	CGTTTCTCACTAAGAA
AAAAAAAAAAGCTAACTCCTAATA	CTAAAGCTCGCAAACT
AAAAAAAATCACCATACAAAGCTC	CTAACCACAAGACTCC
AAAAAAAACAATGCGACAAAGCTC	CTAACCACAAGCCAGA
AAAAAAAAACGCAATACAAAGCTC	CTAACCACACAACAGG
AAAAAAAACCGGTTCACAAAGCTC	CTAACCACAGTAAGTA
AAAAAAAATTAAAGCACAAAGCTC	CTAACCACATAATCCG
AAAAAAAATTCCGGCACAAAGCTC	CTAACCACATATTGAC
AAAAAAAACATTTAGCTATGGAGC	CTAACCCTCCCGTTAC
AAAAAAAATACCCTTCTATGGAGC	CTAACCCTCCTCCTAA
AAAAAAAATAGGATGCTATGGAGC	CTAACCCTCCTTAGGG
AAAAAAAAAAAGGTTCTATGGAGC	CTAACCCTCGATCAGT
AAAAAAAAGGCATGGTGCTCCAAA	CTAACCTGTCATAGAT
AAAAAAAAGAAGCTATGCTCCAAA	CTAACCTGTGACCTGG
AAAAAAAAGGTTCATCTAGAGATT	CTAAGGTTCTTAATGG
AAAAAAAAAATTAGGCTAGAGATT	CTAAGGTTCTTGGATA
AAAAAAAAGGCTTAGGACTAGTGA	CTAAGTCAGACACTTA
AAAAAAAAAATGAGGGACTAGTGA	CTAAGTCAGTAGCCAT
AAAAAAAACTATCGCGACTAGTGA	CTAAGTCAGTCACTCC
AAAAAAAAACGGAACCTACTAGTC	CTAATAGTCATCCACC
AAAAAAAATAAGGTGCTACTAGTC	CTAATAGTCCTCACAC
AAAAAAAAACGGAGTCTACTAGTC	CTAATAGTCCTTAGTT
AAAAAAAAGCCTCAATGATGACTT	CTAATCCGTAACGTGC
AAAAAAAACTCAGGCTGATGACTT	CTAATCCGTAATCCCT
AAAAAAAACAAACAATGATGACTT	CTAATCCGTGTCCAAA
AAAAAAAAGCTCAGGACTGGCTTT	CTAATCGCACTGGCCA
AAAAAAAACGTAAATACTGGCTTT	CTAATCGCAGCTAATT
AAAAAAAAGCCAGCTCTGCAATCT	CTAATCTTCCAGGTCA
AAAAAAAACGTACTTACAGAACCT	CTAATGTCAAATTGCT
AAAAAAAAAAGCCTAACAGAACCT	CTAATGTCATATAACC
AAAAAAAAAGGTTACACAGAACCT	CTAATGTCATCAATCG
AAAAAAAAGTCAAGCGAACAGTTA	CTAATTGAGACTTATG
AAAAAAAATGCTATTGAACAGTTA	CTAATTGAGGGCTTTG
AAAAAAAAGGTTGCAGAACAGTTA	CTAATTGAGTCAGTAC
AAAAAAAAGCTGATGGAACAGTTA	CTAATTGAGTCGCTAG
AAAAAAAATTATCACGAGTGAGGG	CTACAACAGCATTAGC
AAAAAAAAGTGTAATGAGTGAGGG	CTACAACAGGATTTGC
AAAAAAAATGTCCTGGAGTGAGGG	CTACAACAGGTGAGAC
AAAAAAAAGTGGTTAACTGATGAT	CTACCGGCACTCAACA
AAAAAAAAAAGCCTAACTGATGAT	CTACCGGCATATAACC
AAAAAAAATCGACCTGAGCTAAAT	CTACCTCAGGATCCGC
AAAAAAAATCCCTTTGAGCTAAAT	CTACCTCAGGCATTAC
AAAAAAAATCGTGCTGAGCTAAAT	CTACCTCAGTTGCCTC
AAAAAAAATTCCCGTTGGCGAAAT	CTACGAAGTAATCGCA
AAAAAAAAGACAATGTGGCGAAAT	CTACGAAGTTAACACG
AAAAAAAAGAGGTGGGAGTCAATA	CTACTAAAGAGGGACT
AAAAAAAAAGAGGCGGAGTCAATA	CTACTAAAGGCCTAAT
AAAAAAAAGCTGATGGAGTCAATA	CTACTAAAGTCGCTAG
AAAAAAAAGAGGCACTGCCTAATG	CTACTTAGTAAAGCAA
AAAAAAAAGATTGCAACAACATGC	CTAGATTCAATTAAGG
AAAAAAAAACGCAATACAACATGC	CTAGATTCACAACAGG
AAAAAAAAGTGGTTAACAACATGC	CTAGATTCACTCAACA
AAAAAAAAGGGAACAACAACATGC	CTAGATTCACTCGCTC
AAAAAAAATACCTCAACAACATGC	CTAGATTCAGGCCAAA
AAAAAAAATTACCCAACAACATGC	CTAGATTCATTATGAC
AAAAAAAAGTCAATGACAACATGC	CTAGATTCATTGCGGT
AAAAAAAAAAGAACCTGCATTAGC	CTAGCGGGTAATGGAA
AAAAAAAAAGGCAATTGCATTAGC	CTAGCGGGTCATTGTC
AAAAAAAAACGCGTTTGCATTAGC	CTAGCGGGTGAGAAAC
AAAAAAAACCATCACGATTGCTGC	CTAGCTGAGCTACTGG
AAAAAAAATCGACAAGATTGCTGC	CTAGCTGAGGAGGCAT
AAAAAAAACTGCCAGTGCGTGACC	CTAGCTTGTAACGGGA
AAAAAAAATTGTTGGTGCGTGACC	CTAGCTTGTAGGTTTG
AAAAAAAAAGGCTGGTGCGTGACC	CTAGCTTGTCATAACG
AAAAAAAAGGCATGGTGCGTGACC	CTAGCTTGTCATAGAT
AAAAAAAAGACAATGTGCGTGACC	CTAGCTTGTTAACACG
AAAAAAAACGATTCATGCGTGACC	CTAGCTTGTTACCTGT
AAAAAAAAGGGCGATTGTCCGTAA	CTAGGACGTAGACAAA
AAAAAAAATGAGGCATGTCCGTAA	CTAGGACGTGATCATG
AAAAAAAAGTTCCTTTGTCCGTAA	CTAGGACGTGGTTATG
AAAAAAAACCCAGCATGTCCGTAA	CTAGGACGTTAATGAC
AAAAAAAATCCACAATGATTGCAT	CTAGGCGGTTTGCTGT
AAAAAAAATGTAGCCCTTAACGGA	CTAGTAATCACAGCGC
AAAAAAAACCTTGTTCTTAACGGA	CTAGTAATCATCCTCA
AAAAAAAAACCATACCTTAACGGA	CTAGTAATCATGGCCA
AAAAAAAAGCAGTAATGTTTCGGA	CTAGTAGGTATTGGAT
AAAAAAAAGTTCCTTTGTTCGTTT	CTAGTGAGTGGTTATG
AAAAAAAACCCAGCATGTTCGTTT	CTAGTGAGTTAATGAC
AAAAAAAACTTAACCACTGGCCAA	CTAGTTGCAATTAGGA
AAAAAAAATTACGTCACTGGCCAA	CTAGTTGCACAAAGAC
AAAAAAAATCCCATAACTGGCCAA	CTAGTTGCAGAAATGC
AAAAAAAAGGTGATTACTGGCCAA	CTAGTTGCAGCACGAA
AAAAAAAATAGTCAAACTTCGGGA	CTATAACCACATGCTA
AAAAAAAATGTGAGCACTTCGGGA	CTATAACCACTAGCGT
AAAAAAAAGAGCTATACTTCGGGA	CTATAACCAGTACCGT
AAAAAAAACTACCGCACTTCGGGA	CTATAACCATTTGCTC
AAAAAAAAAGCGAGGGACTTGCTG	CTATGACAGGTAAGGC
AAAAAAAAGTCGCTATGACTAAGG	CTATGAGGTAAGCTCA
AAAAAAAATTGACTCACGCTAGGC	CTATGATCAAAGGCCA
AAAAAAAATGAATTGACGCTAGGC	CTATGATCAATAATGG
AAAAAAAACCGTTTAACGCTAGGC	CTATGATCACTGACTA
AAAAAAAAAGAATGAACGCTAGGC	CTATGATCAGGCTGTT
AAAAAAAACCCTGTGACGCTAGGC	CTATGATCATGAGTTT
AAAAAAAATTCGCGCACCAGGTTG	CTATGGCCAAACCTAT
AAAAAAAAGCGTGACACCAGGTTG	CTATGGCCACTAAGAA
AAAAAAAATAGGAGTCTAAAGGTT	CTATGTTTCACTAATG
AAAAAAAATCTTGCTCTAAAGGTT	CTATGTTTCAGTTCCC
AAAAAAAACGCTATGCTAAAGGTT	CTATGTTTCCACCTTA
AAAAAAAATTCCTTGCTAAAGGTT	CTATGTTTCCCGTTTA
AAAAAAAACCGGTTACTAAAGGTT	CTATGTTTCCGTTAAA
AAAAAAAATCCTCTACTAAAGGTT	CTATGTTTCGCACACA
AAAAAAAAAGAGCTGCTTGACCGT	CTATTACTCAAGTGAG
AAAAAAAACTATAACCTTGACCGT	CTATTACTCATTGCAA
AAAAAAAATAGGATGCTTGACCGT	CTATTACTCCTTAGGG
AAAAAAAACCCTAAGCTTGACCGT	CTATTACTCTCAATTC
AAAAAAAATAAAGCATGGCCGGAA	CTATTCAGTGCTCCAC
AAAAAAAATGCTTATGAGCTTAGG	CTATTGAAGTAAACCC
AAAAAAAATGGTGCGGATTACTAC	CTCAATAAGCTGGACC
AAAAAAAACCATGCTGATTACTAC	CTCAATAAGTTCCCAC
AAAAAAAACGATATAACTATCCGT	CTCACAACAATTTAGC
AAAAAAAAAGCGTGCACTATCCGT	CTCACAACAGAAACGT
AAAAAAAATAAATGCACTATCCGT	CTCACAACAGGCCATT
AAAAAAAAGTAGGTTACTATCCGT	CTCACAACAGGCGAGT
AAAAAAAACAGCTAAGACCAAATG	CTCACTCAGGCCAATT
AAAAAAAAGTAGTTAGACCAAATG	CTCACTCAGGCGGATG
AAAAAAAATCTATGTGACCAAATG	CTCACTCAGGGTGAGT
AAAAAAAATTAAGTCCTTCTCACT	CTCAGGATCGGTTACG
AAAAAAAAAGAGCTGCTAAGCACG	CTCATCATCAAGTGAG
AAAAAAAACATTCCTCTAAGCACG	CTCATCATCATGAGCT
AAAAAAAAGTCCTAACTAAGCACG	CTCATCATCCCATAAA
AAAAAAAAACGCTAAACGCTAAAC	CTCATGACAGAAATTG
AAAAAAAATCGTGACCTGGTTCAT	CTCATTGTCCTAATAG
AAAAAAAAGTAGTAACTGGTTCAT	CTCATTGTCCTACCTA
AAAAAAAACGGATTAGACACAATG	CTCATTTAGGTTACGT
AAAAAAAAAACCCTCACCGGGTAT	CTCCAAACAATCTCTC
AAAAAAAAACCTTTAACCGGGTAT	CTCCAAACAGATAGAC
AAAAAAAAATATGCGACCGGGTAT	CTCCAAACAGCAAGGC
AAAAAAAATCCAGCACTAGTAAGT	CTCCAACTCCTAACGG
AAAAAAAAAAATGACCTAGTAAGT	CTCCAACTCGCAGGCT
AAAAAAAAGTTGTTGCTAGTAAGT	CTCCAACTCGTTCACC
AAAAAAAAGTCAAGCGAGTTTGGG	CTCCCTGAGACTTATG
AAAAAAAAATATAGCGAGTTTGGG	CTCCCTGAGTTAACCA
AAAAAAAATCCTCCTACCACATAA	CTCCGGACATAATCAC
AAAAAAAAGGTTACAACCCTGTGC	CTCCGTCCAATACTGT
AAAAAAAACACCATTACCCTGTGC	CTCCGTCCATGCATAT
AAAAAAAACTCAAGGACCCTGTGC	CTCCGTCCATTAGGTT
AAAAAAAATTTCGTCCTTGTTGGC	CTCCTAATCATGGCTG
AAAAAAAACGATAAGCTTGTTGGC	CTCCTAATCCCATAGG
AAAAAAAAGCGCTAGACTGTTCAC	CTCCTCACAAGGTACG
AAAAAAAAAGCTGTAACTGTTCAC	CTCCTCACACGTTACA
AAAAAAAATATGTCCACTGTTCAC	CTCCTCACATAAGTTC
AAAAAAAATTAATGGACTGTTCAC	CTCCTCACATTAGCCA
AAAAAAAACCCAAATTGAGGAGAG	CTCCTGAGTAAGGTCC
AAAAAAAACCTTTATTGAGGAGAG	CTCCTGAGTCATCCTG
AAAAAAAACAATGAATGAGGAGAG	CTCCTGAGTGATGGCT
AAAAAAAAGTCAAGCGATGGCCGA	CTCGACAAGACTTATG
AAAAAAAAATATTGGGATGGCCGA	CTCGACAAGCTTTGGG
AAAAAAAACACAGGCGATGGCCGA	CTCGACAAGGACTTAC
AAAAAAAACGTTATTGATGGCCGA	CTCGACAAGGCTTAAC
AAAAAAAATCATGAGGATGGCCGA	CTCGACAAGTTTGTCT
AAAAAAAAGTGTAACACCGCACTC	CTCGCTCCAACACTTG
AAAAAAAAGCAACTAACCGCACTC	CTCGCTCCAACTAGGG
AAAAAAAACTGAGTGACCGCACTC	CTCGCTCCATCCATCT
AAAAAAAATAAACCAACCGCACTC	CTCGCTCCATTGCAGC
AAAAAAAATAACCTACTGCATCGC	CTCGTTATCCAGCACA
AAAAAAAAGGCATGACTGCATCGC	CTCGTTATCCAGGTTG
AAAAAAAATAGCCACCTGCATCGC	CTCGTTATCGATTTGA
AAAAAAAACTAACCGCTGCATCGC	CTCGTTATCTGTGCAG
AAAAAAAATGAGGAAACCGCAACA	CTCTAAGCAACACCTA
AAAAAAAAATCCGGGACCGCAACA	CTCTAAGCATCATGTG
AAAAAAAATCCGGTACTCTACTAA	CTCTAGCTCAATCATG
AAAAAAAAGATAATGCTCTACTAA	CTCTAGCTCACAGGAA
AAAAAAAAGTGTTTGCTCTACTAA	CTCTAGCTCACCAATA
AAAAAAAAAGCTTACCTCTACTAA	CTCTAGCTCCTTGTTG
AAAAAAAAACGTTGTCTCTACTAA	CTCTAGCTCGATTTAG
AAAAAAAATTGCCAGCTCTACTAA	CTCTAGCTCGCTAAGT
AAAAAAAATCAATTGCTCTACTAA	CTCTAGCTCTCCATAT
AAAAAAAACTTGTAACTCTACTAA	CTCTAGCTCTGCAAAC
AAAAAAAATCTCAAACTCTACTAA	CTCTAGCTCTGCAAGT
AAAAAAAATGCAAGACTTCAAGGA	CTCTATGTCAACCAAC
AAAAAAAATTCTAAGCTTCAAGGA	CTCTATGTCGTACCGA
AAAAAAAAGACAAGCCTTCAAGGA	CTCTATGTCTCAATGA
AAAAAAAAGTAATGTGAACCTTGT	CTCTCACAGGAGGACT
AAAAAAAACGACCTTGAACCTTGT	CTCTCACAGTCAGGCC
AAAAAAAACCGGTAAACATCATGG	CTCTGTTCAAGCCACT
AAAAAAAAGCTCAGGACATCATGG	CTCTGTTCACTGGCCA
AAAAAAAAGGTTTGTCTTGATTAC	CTCTTGATCACGCCAA
AAAAAAAAACTAAAGCTTGATTAC	CTCTTGATCATTTGCT
AAAAAAAATCAAATCCTCATAAGG	CTGAAACTCCGGAACC
AAAAAAAATACCCTTCTCATAAGG	CTGAAACTCCTCCTAA
AAAAAAAAGGTTATCCTCATAAGG	CTGAAACTCGTTATAG
AAAAAAAAAAATACGCTCATAAGG	CTGAAACTCTAACTGA
AAAAAAAATATATCGCTTGAATCT	CTGAATATCAGTATTG
AAAAAAAACGTTTGGCTTGAATCT	CTGAATATCCTTAAGA
AAAAAAAACGATCCTGACTTTGTA	CTGACATAGTGAGGTA
AAAAAAAAACCAGGTGACTTTGTA	CTGACATAGTTGTCAA
AAAAAAAAAGAGGATGATCAAGAC	CTGACCAAGCATGGTT
AAAAAAAAATTGCTCGATCAAGAC	CTGACCAAGCCATCAG
AAAAAAAACCAACCTGATCAAGAC	CTGACCAAGCCTGATG
AAAAAAAACGATTAGGATCAAGAC	CTGACCAAGCTTGCTC
AAAAAAAAGTTGCAGGATCAAGAC	CTGACCAAGGCGAATA
AAAAAAAATGTGGACACGACTAGT	CTGATCACATTGGGAG
AAAAAAAATCCTTAAGACGAAGGA	CTGCAATAGCACAGAA
AAAAAAAAGGGCTATGACGAAGGA	CTGCAATAGGTGAAGC
AAAAAAAAGTGGACACTGACCGAA	CTGCTACTCACTTCAT
AAAAAAAACGATTGCCTGACCGAA	CTGCTACTCATGTTTC
AAAAAAAAGCCTCTCTGAGGAAGG	CTGCTATGTCCTCCAA
AAAAAAAACCTCTGTTGAGGAAGG	CTGCTATGTCGAAGTC
AAAAAAAAGCTTTGGTGAGGAAGG	CTGCTATGTTTGAGGC
AAAAAAAAGGAGCAAACTTCAACC	CTGCTCCCACAGGATG
AAAAAAAATAGACCAGAGAGGCTT	CTGGACCAGCCTTAAA
AAAAAAAAGCCAACAGAGAGGCTT	CTGGACCAGGTCTTGG
AAAAAAAAGGCTAGACTACCTAAC	CTGGATGTCACTAAGC
AAAAAAAACTTGAATCTACCTAAC	CTGGATGTCCCGCAAA
AAAAAAAAGATACTCCTACCTAAC	CTGGATGTCCGCAACA
AAAAAAAAGCGGATACTACCTAAC	CTGGATGTCCTTGAGG
AAAAAAAACCATTATGACCGTTAC	CTGGCTAAGATAGACG
AAAAAAAATAAGGTCGACCGTTAC	CTGGCTAAGCCTGACA
AAAAAAAACCAACCTGACCGTTAC	CTGGCTAAGCCTGATG
AAAAAAAATCCCTTTGACCGTTAC	CTGGCTAAGGCATTAC
AAAAAAAATTGGGTTTGATTGTGT	CTGGTAAGTAACAGGG
AAAAAAAAATACAGGTGATTGTGT	CTGGTAAGTCAATGTG
AAAAAAAAGGCTCATTGATTGTGT	CTGGTAAGTCACCAAA
AAAAAAAAAATACCTTGATTGTGT	CTGGTAAGTTACGCAA
AAAAAAAAGTTAGTAGACAGCCTT	CTGGTCAAGAGGAGTC
AAAAAAAACTTGAAGGACAGCCTT	CTGGTCAAGTAAGAAC
AAAAAAAAGATTTGGACGGTACTA	CTGGTTACAATTAGCT
AAAAAAAAACTGACAACGGTACTA	CTGGTTACACAGGAAT
AAAAAAAAGTGCTGGACGGTACTA	CTGGTTACACCCACCT
AAAAAAAACAAGGCTACGGTACTA	CTGGTTACAGCATGGA
AAAAAAAATTCACTGACGGTACTA	CTGGTTACATCCTGAA
AAAAAAAATTACCCAACGGTACTA	CTGGTTACATTATGAC
AAAAAAAAGTCAATGACGGTACTA	CTGGTTACATTGCGGT
AAAAAAAACGATTAAACGGTACTA	CTGGTTACATTGTCAG
AAAAAAAACACAGGATGGTCAGTC	CTGGTTTGTTATGTGG
AAAAAAAAACGCCTCGAAACGATT	CTGTAACAGCTTAGCG
AAAAAAAAGGATTTAGAAACGATT	CTGTAACAGGAGGTTA
AAAAAAAAAATTAGCGAAACGATT	CTGTAACAGTGTTGCG
AAAAAAAAAGAATCACTTAAGGGT	CTGTACCTCCTCCCTC
AAAAAAAACACCCTCCTTAAGGGT	CTGTACCTCTAGCTAA
AAAAAAAACTTAATGCTTAAGGGT	CTGTACCTCTTAGGGT
AAAAAAAAAACCTGTCTCTCTAGG	CTGTATTTCCCTCATA
AAAAAAAAATTGCTCGAGCTTTGT	CTGTTAAAGCCATCAG
AAAAAAAATAAGGTCGAGCTTTGT	CTGTTAAAGCCTGACA
AAAAAAAACCACAGGGAGCTTTGT	CTGTTAAAGCTCATAA
AAAAAAAACAAATGCGAGCTTTGT	CTGTTAAAGCTGCACA
AAAAAAAAGTTGCAGGAGCTTTGT	CTGTTAAAGGCGAATA
AAAAAAAAGGAGCTTGAGCTTTGT	CTGTTAAAGTCATTTC
AAAAAAAATAGCTGAGAGCTTTGT	CTGTTAAAGTCCTTCA
AAAAAAAAACGGAGTCTTGTTCAA	CTGTTCATCCTTAGTT
AAAAAAAAACTCATGCTTGTTCAA	CTGTTCATCGTTTCTG
AAAAAAAACAGTTATCTTGTTCAA	CTGTTCATCTAAGGAG
AAAAAAAACGTTATGTGGCGAGTG	CTGTTTAGTAATCGTG
AAAAAAAAAGAATCGTGGCGAGTG	CTGTTTAGTACCGGAT
AAAAAAAATCCTTTATGGCGAGTG	CTGTTTAGTACGGTAC
AAAAAAAACTCCTACTGGCGAGTG	CTGTTTAGTTTGACCT
AAAAAAAAAGCAATTGACAAACTG	CTTAACAAGTCTATGA
AAAAAAAAGGCTAAGCTAACCTTG	CTTAAGATCATCAGTA
AAAAAAAACTATTAGCTAACCTTG	CTTAAGATCCAAGTTA
AAAAAAAACGTTTGGCTAACCTTG	CTTAAGATCCTTAAGA
AAAAAAAACCTGCTCCTAACCTTG	CTTAAGATCTTGACCC
AAAAAAAACGCACCATGACGAAGT	CTTAAGGGTTGTGACA
AAAAAAAAACAGCACGAGTTTGCT	CTTAATGAGCATGACT
AAAAAAAAGAGAAACGAGTTTGCT	CTTAATGAGGAAACTG
AAAAAAAATCCGGTTGAGTTTGCT	CTTAATGAGTGCTGTG
AAAAAAAACACTAAGGAGTTTGCT	CTTAATGAGTTCCTCA
AAAAAAAATTCCCGTTGATTCAGT	CTTACCGGTAATCGCA
AAAAAAAATCCGTTAACCAGTATA	CTTACCTCAATAAGCA
AAAAAAAATACGGACACCAGTATA	CTTACCTCAGCCGCTA
AAAAAAAACTTCATGACCAGTATA	CTTACCTCAGGCCTTG
AAAAAAAACCCGGTTACCAGTATA	CTTACCTCAGGCTTCG
AAAAAAAACAAACATACCAGTATA	CTTACCTCAGGTTACC
AAAAAAAAGTAGGATTGGCTAGAA	CTTACTAGTTCCGGGA
AAAAAAAAATGGCCTTGGCTAGAA	CTTACTAGTTTATCGC
AAAAAAAAATGACAGTGGCTAGAA	CTTACTAGTTTATGGG
AAAAAAAAATCCCAGTGTCACGCG	CTTAGGAGTGCTTACT
AAAAAAAAATTACGCCTGACCATT	CTTAGTTTCCACAATA
AAAAAAAAAATAAGCCTTATGTTG	CTTATGTTCCCTCACG
AAAAAAAACCAGGGACTTATGTTG	CTTATGTTCCCTCTAA
AAAAAAAACTACTGGCTTATGTTG	CTTATGTTCCCTGTTA
AAAAAAAAGCCTGGTCTTATGTTG	CTTATGTTCCGCAAAT
AAAAAAAAGACCTGCCTTATGTTG	CTTATGTTCTAGCGAT
AAAAAAAACAGATAATGAGTGATG	CTTATTGGTAGGTTAT
AAAAAAAATTTGAGCTGAGTGATG	CTTATTGGTCATCAAG
AAAAAAAATAAGCCTTGAGTGATG	CTTATTGGTTCATTTG
AAAAAAAAGATTTGGACTTAATGG	CTTCAAGCAATTAGCT
AAAAAAAAGGAATAAACTTAATGG	CTTCAAGCAGTTATCG
AAAAAAAACGGTTAGACTTAATGG	CTTCAAGCATAGCGAG
AAAAAAAATAACCTACTAGGCCCT	CTTCAATTCCAGCACA
AAAAAAAAGCAATAACTAGGCCCT	CTTCAATTCCAGGGAG
AAAAAAAAACAGAATCTAGGCCCT	CTTCAATTCGATATTG
AAAAAAAAAATTAGGCTAGGCCCT	CTTCAATTCTTGGATA
AAAAAAAATGCGTGAACCAGGAAA	CTTCACTCACATTAAC
AAAAAAAAGTGAGGAACCAGGAAA	CTTCACTCACGTAATT
AAAAAAAACAAACATACCAGGAAA	CTTCACTCAGGTTACC
AAAAAAAATGTAAGTACCAGGAAA	CTTCACTCATTATGGT
AAAAAAAAGAGGTGGGATAGACCA	CTTCAGGAGAGGGACT
AAAAAAAAAGGACTTACATGCAAC	CTTCATCCACTTAACG
AAAAAAAAGGTACTAACATGCAAC	CTTCATCCAGTCTAAT
AAAAAAAATAGTAACACATGCAAC	CTTCATCCAGTTTGTG
AAAAAAAAGATCCAGGAATATCGA	CTTCTCAAGCCGCTTT
AAAAAAAACAGTTAGGAATATCGA	CTTCTCAAGTAAGTGG
AAAAAAAAACACCTTGAATATCGA	CTTCTCAAGTTGTCTT
AAAAAAAACCTAATTGACTATGGA	CTTGAACAGCCGCAGT
AAAAAAAAAAGAAGCGACTATGGA	CTTGAACAGCGATAAG
AAAAAAAATTAGGACGACTATGGA	CTTGAACAGGGTTATC
AAAAAAAAAGTCCTCACCGGCCTT	CTTGAATCAAGTGAAC
AAAAAAAATGGCATGACGGATTTG	CTTGCAACATAAGTCT
AAAAAAAAGATGACTACGGATTTG	CTTGCAACATAGCAGG
AAAAAAAATCCAACATGAATCTCA	CTTGCATGTCAAAGAA
AAAAAAAACTTAGTGTGAATCTCA	CTTGCATGTGAAACAA
AAAAAAAAAGGGTGGGAGTTGCCC	CTTGCTCAGAATGACG
AAAAAAAAGAGGGTGGAGTTGCCC	CTTGCTCAGGGACGCA
AAAAAAAACTAAAGCGAGTTGCCC	CTTGCTCAGTGTGATC
AAAAAAAATCGATTTGAATATAGC	CTTGTAAAGCGAAGTA
AAAAAAAACGTAATGGAATATAGC	CTTGTAAAGTTACTTC
AAAAAAAATCAGTTTGAATATAGC	CTTGTAAAGTTAGGCT
AAAAAAAAGCTTAAAGAGCTTGCC	CTTGTCCAGGCTACAT
AAAAAAAAGTAACACACAAGCTCA	CTTGTTCCAAACAACA
AAAAAAAACTTAACCACAAGCTCA	CTTGTTCCAATTAGGA
AAAAAAAAGAGGTGAACAAGCTCA	CTTGTTCCACACTAAT
AAAAAAAATAAACGTACAAGCTCA	CTTGTTCCAGCAATAA
AAAAAAAACAAGGCTACAAGCTCA	CTTGTTCCAGCATGGA
AAAAAAAACCTTAATGAAAGGCCT	CTTGTTTAGTCATTAG
AAAAAAAACCCAATTACTTGACCT	CTTTAGGCACCATATG
AAAAAAAAGATGACTACTTGACCT	CTTTAGGCATAGCAGG
AAAAAAAAACAAGGCCTTTCATCC	CTTTAGTTCGATAACC
AAAAAAAAAGTCATCCTTTCATCC	CTTTAGTTCGTGCTAG
AAAAAAAAGTGATGATGGATTCAT	CTTTATGGTAACCACA
AAAAAAAACCTCTGTTGGATTCAT	CTTTATGGTCGAAGTC
AAAAAAAATAGAAACTGGATTCAT	CTTTATGGTCGACTAA
AAAAAAAAAAGCATGTGGATTCAT	CTTTATGGTTTGGCGG
AAAAAAAACAGATAATGAGCTTGC	CTTTCTTGTAGGTTAT
AAAAAAAATAGACCAGATTATGTC	CTTTGGGAGCCTTAAA
AAAAAAAAGTTACCTGATTATGTC	CTTTGGGAGGATTGCT
AAAAAAAAGGTCCATTGGATTACT	CTTTGGTGTCGTAATG
AAAAAAAAGGAGGCTTGGATTACT	CTTTGGTGTTCAAGCA
AAAAAAAAAGCGATTACCCAAACG	CTTTGTCCAAGCTAAA
AAAAAAAAGCCACTTACCCAAACG	CTTTGTCCACCCTCAC
AAAAAAAAACCGAATACCCAAACG	CTTTGTCCAGGACCAA
AAAAAAAACTAGTCTACCCAAACG	CTTTGTCCAGTTTACG
AAAAAAAATCCTTTATGGGTTAGA	GAAACCCGTACGGTAC
AAAAAAAAACTATGTTGGGTTAGA	GAAACCCGTACTTCAC
AAAAAAAATACTCCCTGGGTTAGA	GAAACCCGTCAATAGT
AAAAAAAACAATCCATGGGTTAGA	GAAACCCGTCCAAATG
AAAAAAAATCTTTGTTGGGTTAGA	GAAACCCGTCTCAGCC
AAAAAAAAGCACTAGGAAGGCTGT	GAAACTGAGCTAATTG
AAAAAAAAGTCACAGGAAGGCTGT	GAAACTGAGGACGTAA
AAAAAAAATGCGCTTGAAGGCTGT	GAAACTGAGTTTAACG
AAAAAAAACGCTTGTGATAACTTC	GAAAGCCAGTAACGGA
AAAAAAAAACATTGCCTACTGATC	GAAAGGCTCAGAAACG
AAAAAAAAGGTTGTTCTACTGATC	GAAAGGCTCCAACTGG
AAAAAAAACAACAAGCTACTGATC	GAAAGGCTCCCTTGCG
AAAAAAAACTATTGACTACTGATC	GAAAGGCTCCTAAGAC
AAAAAAAACCCTAAGCTACTGATC	GAAAGGCTCTCAATTC
AAAAAAAACTATTTGGACTAGGAT	GAACACAAGATGCCTG
AAAAAAAAGATTAGTGACTAGGAT	GAACACAAGCTTATGA
AAAAAAAAGATGGCTGACTAGGAT	GAACACAAGGACACTT
AAAAAAAATCGACAAGACTAGGAT	GAACACAAGGAGGCAT
AAAAAAAAGGATTTAGACTAGGAT	GAACACAAGGAGGTTA
AAAAAAAATCGACCTGACTAGGAT	GAACACAAGGATCCGC
AAAAAAAATCTCAATGACCTCAAC	GAACCAAAGGTCATTA
AAAAAAAATAGCTGAGACCTCAAC	GAACCAAAGTCCTTCA
AAAAAAAAGCTCAGGACGCAATCA	GAACCAGCACTGGCCA
AAAAAAAACTAGTAAACGCAATCA	GAACCAGCAGTAAAGC
AAAAAAAAAGGCCCAACGCAATCA	GAACCAGCATGCAACC
AAAAAAAACGTGAAACTATGGATA	GAACCGCTCAAGGACA
AAAAAAAACACCCTCCTATGGATA	GAACCGCTCTAGCTAA
AAAAAAAACTAGCCACTTAGCGCT	GAACCTGTCCTGAATA
AAAAAAAATCAGCACCTTAGCGCT	GAACCTGTCGAAGTAG
AAAAAAAACCCTTTACTTAGCGCT	GAACCTGTCGCCTAAG
AAAAAAAAATGTGCGGATGCAAGT	GAACCTTAGCCTGTGA
AAAAAAAAGTAATGTGATGCAAGT	GAACCTTAGGAGGACT
AAAAAAAAATATCGCCTAGCTAAA	GAACGAATCATAAGCC
AAAAAAAATGACTTACTAGCTAAA	GAACGAATCGAGGTGG
AAAAAAAATGGCTCACTCACTATA	GAACTTATCGATTCTT
AAAAAAAAAGGCAATTGACACAAG	GAAGCCTGTCATTGTC
AAAAAAAATCCGTAATGACACAAG	GAAGCCTGTTCACCAT
AAAAAAAAGCTAAATGACAAAGTC	GAAGCTAAGATAACCC
AAAAAAAAGTTTCCAGACAAAGTC	GAAGCTAAGCTGGCTA
AAAAAAAAGATTCCTGACAAAGTC	GAAGCTAAGGACCTCA
AAAAAAAACACAGCGGACAAAGTC	GAAGCTAAGGCTGTGC
AAAAAAAATATCAGGGACAAAGTC	GAAGCTAAGTTACCGG
AAAAAAAAGGAAGCAACCCGCCAT	GAAGGAACACTAAGTT
AAAAAAAACTTCCTCACCCGCCAT	GAAGGAACAGGATAAC
AAAAAAAAGTCCTGATGCGATTAC	GAAGGATGTCACCTAT
AAAAAAAAGCTTCTTTGCGATTAC	GAAGGATGTGAGACTC
AAAAAAAAACATGTTTGCGATTAC	GAAGGATGTTCCTGTG
AAAAAAAAGTTCACCACCTAGTAA	GAAGGCCCAGCTTAAT
AAAAAAAAGGTACTAACCTAGTAA	GAAGGCCCAGTCTAAT
AAAAAAAATCCAGGAACCTAGTAA	GAAGGCCCATCACAGC
AAAAAAAATGGGTTAGAACCGCAA	GAAGGCTAGCTATGAC
AAAAAAAACGGAAACTGGTTCAAT	GAAGTAAGTTAACGAT
AAAAAAAACCAGGTGGATCAATCT	GAAGTATAGACTATTG
AAAAAAAATGCAACAGATAGACTG	GAAGTCAAGAGGCTAA
AAAAAAAAGAGAAACGATAGACTG	GAAGTCAAGGAAACTG
AAAAAAAAAGGCTGTGATAGACTG	GAAGTCAAGGCTAGAA
AAAAAAAAGTGATTAGATAGACTG	GAAGTCAAGGTCCGTA
AAAAAAAAGCCAACAGATAGACTG	GAAGTCAAGGTCTTGG
AAAAAAAAGGAATATCTTTAGCGC	GAAGTGATCCAAACAC
AAAAAAAATTCCTTGCTTTAGCGC	GAAGTGATCCCGTTTA
AAAAAAAATATCACACTTTAGCGC	GAAGTGATCTACCTAT
AAAAAAAAGATGCAGCTTTAGCGC	GAAGTGATCTCCTCTT
AAAAAAAAGTTAAAGCTTTAGCGC	GAAGTGATCTCGCCTG
AAAAAAAAAATTAGGCTTTAGCGC	GAAGTGATCTTGGATA
AAAAAAAACTTAATGCTGGTCAAG	GAATTTGTCTTAGGGT
AAAAAAAAAATTAGGCTGGTCAAG	GAATTTGTCTTGGATA
AAAAAAAACCACTTAACCCGCTAC	GACAATACACATTGCA
AAAAAAAAAAAGTGAACCCGCTAC	GACAATACATTTAAGC
AAAAAAAATGGCTATTGAGCGCTT	GACACCGGTTCACTGT
AAAAAAAAAAACCCGGAACTTAAG	GACATAGAGGCGTAAA
AAAAAAAACACCAGGGAACTTAAG	GACATAGAGTAACTCA
AAAAAAAACTATATGCTGGACGTA	GACATTATCCCTGATC
AAAAAAAAGCGGATACTGGACGTA	GACATTATCCTTGAGG
AAAAAAAACCCTAAGCTGGACGTA	GACATTATCTCAATTC
AAAAAAAACAAACATACAAACGGG	GACCGAACAGGTTACC
AAAAAAAAGCAGTTAACTCACCTA	GACCGTTCAACTAGAA
AAAAAAAATGATCCTACTCACCTA	GACCGTTCACTGGCTG
AAAAAAAAGCCAAATACTCACCTA	GACCGTTCACTTCATC
AAAAAAAAGCCTCAATGATCAGCC	GACCTAAGTAACGTGC
AAAAAAAAACTAGGATGATCAGCC	GACCTAAGTGTTTGCT
AAAAAAAATAGACAATGATCAGCC	GACCTAAGTTAAATGC
AAAAAAAAATGACTTTGATCAGCC	GACCTAAGTTATCCGT
AAAAAAAATCCCTCATGATCAGCC	GACCTAAGTTCCGCAC
AAAAAAAATTGAAGGCTGAATCTC	GACCTAGTCGCCTGTT
AAAAAAAAGTAAACTGATCAGCAA	GACCTCAAGCCGCTAA
AAAAAAAAACCTAAAGATCAGCAA	GACCTCAAGCTTCTCA
AAAAAAAATCGACAAGATCAGCAA	GACCTCAAGGAGGCAT
AAAAAAAACATAGTGGATCAGCAA	GACCTCAAGGGTGAAC
AAAAAAAAACCTCGCGACCTTTGG	GACCTGCAGCACTAAC
AAAAAAAACCGGTTTGACCTTTGG	GACCTGCAGCGCATTG
AAAAAAAATGCTTCCTGATGCACC	GACCTTTGTAGCAGCT
AAAAAAAACCGGTTCACAAGCCTA	GACGCAACAGTAAGTA
AAAAAAAAAACCTAAGAATAATCG	GACGCCTAGAATCTCA
AAAAAAAATCGTTATGATAGCCAA	GACGTAAAGTTTGGGT
AAAAAAAAAGGCTGGTGGTACACC	GACTAATGTCATAACG
AAAAAAAACTACTAGTGGTACACC	GACTAATGTCCAAGAC
AAAAAAAATCTTCATTGGTACACC	GACTAATGTGGACATC
AAAAAAAACGTGCTGTGGTACACC	GACTAATGTTTAGCGA
AAAAAAAACAGGAGGACCTGCGAA	GACTATTCAAGGGTTG
AAAAAAAACGGGATTACGGAGCAA	GACTCACCACATAGCC
AAAAAAAAGCCCAAAGACTTGGTC	GACTTACAGCCGCAAC
AAAAAAAATGGCTAAGACTTGGTC	GACTTACAGCTCCTAC
AAAAAAAAAGAGCAAGACTTGGTC	GACTTACAGGAAGTAT
AAAAAAAATCCACCTTGATCCTAA	GACTTAGGTAAGGTTT
AAAAAAAAGCTCCCTTGATCCTAA	GACTTAGGTCTCACTG
AAAAAAAAATCACTATGATCCTAA	GACTTAGGTTAAGGCC
AAAAAAAATTAGGAGCTTTGCTCT	GACTTGGTCACGTTAA
AAAAAAAACATTCCTCTTTGCTCT	GACTTGGTCATGAGCT
AAAAAAAATGCGTGTCTTTGCTCT	GACTTGGTCCTGGTGA
AAAAAAAAGCCTAATCTTTGCTCT	GACTTGGTCGTTAGTA
AAAAAAAAATAGATGCTTTGCTCT	GACTTGGTCTACCTGC
AAAAAAAAAGAACCGCTTTGCTCT	GACTTGGTCTCACACC
AAAAAAAACTCGAGCTGCAATCCA	GAGAAACGTAACTACG
AAAAAAAATCCTAAGTGCAATCCA	GAGAAACGTTAACGGC
AAAAAAAACCCTCCTGAACAATAC	GAGAACCAGACACCGC
AAAAAAAACTCAAAGGAACAATAC	GAGAACCAGGAAGCTA
AAAAAAAAGTGCGAGTGTCCTTGC	GAGAGGCGTATTGAGT
AAAAAAAAGCCTTAGTGTAGCCTA	GAGATAAGTGATTTGG
AAAAAAAACAGCGCTTGTAGCCTA	GAGATAAGTGTAATAC
AAAAAAAAGTACCGTTGTAGCCTA	GAGATAAGTTAGCTGA
AAAAAAAATGACAAATGTAGCCTA	GAGATAAGTTTAACGG
AAAAAAAAAGAAACCTGCTTATCT	GAGCAAGGTCATTAGG
AAAAAAAAGATGACTACACGCGGT	GAGCATGCATAGCAGG
AAAAAAAAGTAATCGACCGGCTCT	GAGCCTTCAACAGCCT
AAAAAAAATCCTCCTACCGGCTCT	GAGCCTTCATAATCAC
AAAAAAAATCGAAGCACCGGCTCT	GAGCCTTCATTGTGGC
AAAAAAAAGCCATCATGGAGGAAG	GAGCGAAGTAGTAAGA
AAAAAAAACCACTTGGATTGCATT	GAGCGATAGCAACATC
AAAAAAAATTCTTAGGATTGCATT	GAGCGATAGCTGGAAA
AAAAAAAAGCTTGAGGATTGCATT	GAGCGATAGGTCCTAG
AAAAAAAACCAGCAAACCAGGATC	GAGCTAGCACCAGGTT
AAAAAAAAGTGCAAGCTCGCTTGA	GAGCTGCTCCGCCTAT
AAAAAAAATGTGCACCTCGCTTGA	GAGCTGCTCGCTAAAC
AAAAAAAACGGAGCACTAGAGGCT	GAGCTTGTCCTAGTAA
AAAAAAAATTGCTTAGAGCAATTA	GAGGACTAGACAAAGT
AAAAAAAATGGTCAAGAGCAATTA	GAGGACTAGTTTGCGG
AAAAAAAATGCTGTTACAATTGCG	GAGGAGGCAAGGATTA
AAAAAAAAAAGATAGACAATTGCG	GAGGAGGCAGCTTAGC
AAAAAAAAGTACCTCACAATTGCG	GAGGAGGCATGGAGGC
AAAAAAAACTGGTTATGTCCAGCG	GAGGCAAGTGCTGTAA
AAAAAAAAGAATGCATGTCCAGCG	GAGGCAAGTTAGCATG
AAAAAAAAATGCTATTGTCCAGCG	GAGGCAAGTTAGTTGG
AAAAAAAATTAAGGATGTCCAGCG	GAGGCAAGTTGGATCA
AAAAAAAATCCCTCTACGCCTCTA	GAGGCTACAATCATGT
AAAAAAAACAAACATACGCCTCTA	GAGGCTACAGGTTACC
AAAAAAAAAGGATAAACGCCTCTA	GAGGCTACATGTTTGG
AAAAAAAATCACGATTGTCATCCC	GAGGCTTGTTTACGTC
AAAAAAAACAAGGGTTGTCATCCC	GAGGCTTGTTTGTGGA
AAAAAAAAGGACCATGACCTTACG	GAGGTACAGCTCAATA
AAAAAAAATTTAGCTGACCTTACG	GAGGTACAGTAATCCA
AAAAAAAAGGATCCAGACCTTACG	GAGGTACAGTGAACGA
AAAAAAAAGCAATGCGAGAAGCAA	GAGGTTAAGAGGAAGG
AAAAAAAAGTAAACTGAGAAGCAA	GAGGTTAAGCCGCTAA
AAAAAAAACGTTTCGGAGAAGCAA	GAGGTTAAGGGATGCG
AAAAAAAAGGCCGATACTTGCTCA	GAGTAACCAATTAACC
AAAAAAAATCAATCCACTTGCTCA	GAGTAACCAGGCGATA
AAAAAAAATAGAATCACTTGCTCA	GAGTAACCAGTAATAG
AAAAAAAATTACTGCACTTGCTCA	GAGTAACCAGTATGTT
AAAAAAAAACCGTTCACTTGCTCA	GAGTAACCAGTTGCGT
AAAAAAAAGAATTTGGATTGCGCT	GAGTAATAGCATTTCT
AAAAAAAAACAATAGCTATGTGGG	GAGTATCTCTAAATCG
AAAAAAAACTAACCGCTATGTGGG	GAGTATCTCTGTGCAG
AAAAAAAACTGATTTGAGGTCCAA	GAGTCAAAGCTTTGTT
AAAAAAAAGGTAGCTGAGGTCCAA	GAGTCAAAGTCTTGAA
AAAAAAAAGCGGTCAACGCAATGT	GAGTGATCAACCGCCA
AAAAAAAATTGCATCACGCAATGT	GAGTGATCAAGTGTTT
AAAAAAAAACTGACAACGCAATGT	GAGTGATCACAGGAAT
AAAAAAAACAGGATCACGCAATGT	GAGTGATCATCTTGAG
AAAAAAAAGGTGTGACTTAGCTCG	GAGTGTTTCCAAGTGT
AAAAAAAACAAGCTCCTCGATATT	GAGTTACTCCATAAGC
AAAAAAAATTCCTTGCTCGATATT	GAGTTACTCCCGTTTA
AAAAAAAACTCCCACCTCGATATT	GAGTTACTCCCTGACT
AAAAAAAATCTAGCGCTCGATATT	GAGTTACTCGCGCTAA
AAAAAAAATTCGCGACTCGATATT	GAGTTACTCTGTAATG
AAAAAAAAGTGATGATGGCTTGAC	GAGTTTGGTAACCACA
AAAAAAAATCGATCATGGCTTGAC	GAGTTTGGTCCACAAA
AAAAAAAAACTAGTTTGGCTTGAC	GAGTTTGGTCTAACCT
AAAAAAAACGATTCATGGCTTGAC	GAGTTTGGTTACCTGT
AAAAAAAACCAATACTGGATGACA	GATAAAGGTATGGTGC
AAAAAAAAAACTTGTTGGATGACA	GATAAAGGTGCTCCGT
AAAAAAAATCTCACCTGGATGACA	GATAAAGGTTCGCTCA
AAAAAAAAAGAGGATGAACGGTGT	GATAACGAGCATGGTT
AAAAAAAACAGCTAAGAACGGTGT	GATAACGAGGCCAATT
AAAAAAAAGTAGTTAGAACGGTGT	GATAACGAGGCGGATG
AAAAAAAATAGCCCTGAACGGTGT	GATAACGAGTGAACCT
AAAAAAAATTGTTGCACGTAATGC	GATAAGCCAGAGGGAG
AAAAAAAAGGCAATATGCTACTCC	GATAATCGTAGGATTT
AAAAAAAAGTTCCTTTGCTACTCC	GATAATCGTGGTTATG
AAAAAAAACTTCGCTTGCTACTCC	GATAATCGTTAGGATT
AAAAAAAAAACTGAGTGCTACTCC	GATAATCGTTGCTGGG
AAAAAAAATATGACAACTGGTCAG	GATAGACCAATTATGC
AAAAAAAAATACCGAACTGGTCAG	GATAGACCACCAGCAT
AAAAAAAAAAAGTGAACTGGTCAG	GATAGACCATTTAAGC
AAAAAAAACCTTACGGACGCAAGC	GATCAAGAGGAGCATA
AAAAAAAAAGCTAATGACGCAAGC	GATCAAGAGTGGACAA
AAAAAAAATATTCGTGATTCCCAG	GATCACTAGCTCCCTG
AAAAAAAAATGCTTCGATTCCCAG	GATCACTAGCTCCTTA
AAAAAAAAAGTTAACGATTCCCAG	GATCACTAGGAACGGT
AAAAAAAATTAGGAGCTAAATCCC	GATCAGTTCACGTTAA
AAAAAAAAAAGAACAACGAAGGAC	GATCCGTCAAACATAG
AAAAAAAAAGTAACCACGAAGGAC	GATCCGTCACTTGTTC
AAAAAAAACGCATCCACGAAGGAC	GATCCGTCAGTAGGAT
AAAAAAAATGCGTGAACTTAACGA	GATCGAGCACATTAAC
AAAAAAAATGGTTAAACTTAACGA	GATCGAGCATCTAGCA
AAAAAAAAAGTCTTGCTAAACCCT	GATCGATTCAAGCTAC
AAAAAAAAGCGATAGCTAAACCCT	GATCGATTCTAATTGG
AAAAAAAAAATCGTGACATCCACC	GATCGCTCAGTTTCTC
AAAAAAAAAGGATAAACATCCACC	GATCGCTCATGTTTGG
AAAAAAAAGAAGCACCTCCGCTAA	GATGACTTCAAACCTA
AAAAAAAAAGTTGTCCTCCGCTAA	GATGACTTCAATTACG
AAAAAAAAATATCGCCTCCGCTAA	GATGACTTCATAAGCC
AAAAAAAACATTTAGCTCCGCTAA	GATGACTTCCCGTTAC
AAAAAAAAACGTATTTGTGGTGAG	GATGAGGGTACCGTTT
AAAAAAAAAGCCAAATGTGGTGAG	GATGAGGGTTCTTTAG
AAAAAAAAGAGCGCTACGCTTACC	GATGCAGCAACCTGGT
AAAAAAAAGGTACGCACGCTTACC	GATGCAGCACTTCACT
AAAAAAAACTTCCTCACGCTTACC	GATGCAGCAGGATAAC
AAAAAAAAGCGGTACACGCTTACC	GATGCAGCATAGTCAT
AAAAAAAAAGTCTTGCTTGAGGCG	GATGCATTCAAGCTAC
AAAAAAAAAGTAAGTCTTGAGGCG	GATGCATTCAATACGC
AAAAAAAAAAACATGCTTGAGGCG	GATGCATTCCAATAGC
AAAAAAAATTCAGTACTTGAGGCG	GATGCATTCCCTGGTT
AAAAAAAACGCAGGACTTGAGGCG	GATGCATTCGGCTAGC
AAAAAAAATTCTAAGCTTGAGGCG	GATGCATTCGTACCGA
AAAAAAAACTTGTAACTTGAGGCG	GATGCATTCTGCAAAC
AAAAAAAACTTGACCGATCCCTGA	GATGCTTAGGCCATCA
AAAAAAAACATAACGGATCCCTGA	GATGCTTAGGGACCTC
AAAAAAAAGTTAGGCGAGCATGCA	GATGGACAGCAGGTTT
AAAAAAAACCGCTTAGAGCATGCA	GATGGACAGTAAAGGT
AAAAAAAACAGTAATACGAGGAAC	GATTAAGCAAATGCCC
AAAAAAAAAACGGGAACGAGGAAC	GATTAAGCAACTAACT
AAAAAAAAGCCATAAACGAGGAAC	GATTAAGCACCTGTAA
AAAAAAAAGGTGATTACGAGGAAC	GATTAAGCAGCACGAA
AAAAAAAAAAGACAAACGAGGAAC	GATTAAGCATCCTAGA
AAAAAAAACACAATAACGAGGAAC	GATTAAGCATCGTTCT
AAAAAAAACACAGGATGCCTGCGA	GATTACGGTTATGTGG
AAAAAAAACAGTAATACTAAGCAT	GATTACTCAAATGCCC
AAAAAAAACCGCCTAACTAAGCAT	GATTACTCACTAAGCC
AAAAAAAAGTAGGTTACTAAGCAT	GATTACTCAGGCGAGT
AAAAAAAACCGGTTCACTAAGCAT	GATTACTCAGTAAGTA
AAAAAAAAACTATGTTGCGGATAG	GATTAGTGTACTTCAC
AAAAAAAACGGTTTATGCGGATAG	GATTAGTGTTACTTCA
AAAAAAAACCTTACCTGCGGATAG	GATTAGTGTTCATCTA
AAAAAAAAAGTTGTCCTGACCAAG	GATTATGTCAATTACG
AAAAAAAACATAATCCTGACCAAG	GATTATGTCACGAATC
AAAAAAAAGAAAGCCCTGACCAAG	GATTATGTCAGGATGA
AAAAAAAATAGGATGCTGACCAAG	GATTATGTCCTTAGGG
AAAAAAAAGTCAATCCTGACCAAG	GATTATGTCGCTATAA
AAAAAAAATGTATTGCTTGCATAT	GATTCAATCATCACTT
AAAAAAAACTAGTGCCTTGCATAT	GATTCAATCATTACGA
AAAAAAAATTGCCAGCTTGCATAT	GATTCAATCGCTAAGT
AAAAAAAAGTAATGACTTGCATAT	GATTCAATCGGTTTGG
AAAAAAAAAAATACGCTTGCATAT	GATTCAATCTAACTGA
AAAAAAAATACCGCACTTGCATAT	GATTCAATCTTGTCCA
AAAAAAAAAGCAAACTGACTATGT	GATTCAGGTAATCGGC
AAAAAAAATGCAGGATGACTATGT	GATTCAGGTTTCCTCC
AAAAAAAAGATCATGACTTGGATA	GATTCATCAAAGCTCC
AAAAAAAAGTGGATTACTTGGATA	GATTCATCAGCAACAG
AAAAAAAACTGCCAGTGGCGGTTT	GATTCCTGTAACGGGA
AAAAAAAAATATACCTGGCGGTTT	GATTCCTGTAGTCAAT
AAAAAAAATCGATCATGGCGGTTT	GATTCCTGTCCACAAA
AAAAAAAAAGTAACGTGGCGGTTT	GATTCCTGTCTAGCTT
AAAAAAAAAGGCTAATGGCGGTTT	GATTCCTGTGATGAAA
AAAAAAAAGAGCTGGTGGCGGTTT	GATTCCTGTGCATTTC
AAAAAAAACTACTGATGGCGGTTT	GATTCCTGTTACTTGC
AAAAAAAAAATTGCGACATAGCTG	GATTCGCCAATGAGGT
AAAAAAAAAGTAGGTTGCTGGCCA	GATTGATGTCGCATAA
AAAAAAAACGGAAACTGCTGGCCA	GATTGATGTTAACGAT
AAAAAAAACCCAGCATGCTGGCCA	GATTGATGTTAATGAC
AAAAAAAAGCTTCTTTGCCGCACA	GATTGCAGTGAGACTC
AAAAAAAAGCGTTTGTGCCGCACA	GATTGCAGTGTTTGTC
AAAAAAAAGTCGCTATGTGGTTAC	GATTGGCGTAAGCTCA
AAAAAAAATTACAACCTGTTGTCA	GATTGGTTCCTGGTCT
AAAAAAAACGTTTGTACTCGCGAA	GATTGTTCACAAAGCG
AAAAAAAAGGTGATTACTCGCGAA	GATTGTTCAGCACGAA
AAAAAAAACATAGGTGATGCCTCA	GATTTGCAGGCATGTT
AAAAAAAACCCGATTGATCATATC	GCAAACAAGGAGTCGG
AAAAAAAAGGGAACCTGTTGGAGG	GCAAACCGTGGATTCA
AAAAAAAATAACCTACTTGACCTG	GCAAACTTCCAGCACA
AAAAAAAAATTGTGCCTTGACCTG	GCAAACTTCCCAGTAG
AAAAAAAATTACCGGCTTGACCTG	GCAAACTTCCCTCGCA
AAAAAAAATGCGTGTCTTGACCTG	GCAAACTTCCTGGTGA
AAAAAAAATGCATCGCTTGACCTG	GCAAACTTCGAGGAAC
AAAAAAAAACAATAGCTTGACCTG	GCAAACTTCTAAATCG
AAAAAAAATACAACAACCTGCAAG	GCAACAGCAACTAGCC
AAAAAAAATGCGCCTACCTGCAAG	GCAACAGCAATATACC
AAAAAAAATCCCTCTACCTGCAAG	GCAACAGCAATCATGT
AAAAAAAAAACGGTTACCTGCAAG	GCAACAGCAATGCCTA
AAAAAAAACGATATAACCTGCAAG	GCAACAGCAATTTAGC
AAAAAAAACCATTGTACCTGCAAG	GCAACAGCATAAGGAC
AAAAAAAACCGAAGTACCTGCAAG	GCAACAGCATGGCCCA
AAAAAAAATCAAGGACTAGTCGAG	GCAAGCCTCATAGACC
AAAAAAAAGATTGCAACAGCCTAA	GCAAGTGCAATTAAGG
AAAAAAAACCCAATTACAGCCTAA	GCAAGTGCACCATATG
AAAAAAAAGCTAAATGATCCAGGG	GCAATAGAGATAACCC
AAAAAAAATGGTTAGGATCCAGGG	GCAATAGAGGAACCGG
AAAAAAAACGATTGAGATCCAGGG	GCAATAGAGGTGAAAT
AAAAAAAAGATGGCTGACAAGTGT	GCAATCTAGGACACTT
AAAAAAAATCATCATGAGTGAACC	GCAATGAAGTCATTGA
AAAAAAAACATAATCCTGTCCAGC	GCAATGTTCACGAATC
AAAAAAAACGGGAACCTGTCCAGC	GCAATGTTCAGCCAAT
AAAAAAAATATAACCCTGTCCAGC	GCAATGTTCCTGAGTG
AAAAAAAACCAGGTGGATATTTCG	GCACATTAGACTATTG
AAAAAAAAGCCGATAGATATTTCG	GCACATTAGTAACGAG
AAAAAAAACACCAGGGATATTTCG	GCACATTAGTAACTCA
AAAAAAAACCATAAGGATATTTCG	GCACATTAGTTGGCCA
AAAAAAAACGCTAAAGAAACCTAA	GCACCTAAGACAACGA
AAAAAAAAGATTTGAGAAACCTAA	GCACCTAAGGGTCTAT
AAAAAAAACCATAAGGAAACCTAA	GCACCTAAGTTGGCCA
AAAAAAAAAGACTCAACGGATTAC	GCACGAACAATGCCCG
AAAAAAAAACCGCCACTCTAGGCT	GCACGGTTCATGTGGT
AAAAAAAATGAGTGACTCTAGGCT	GCACGGTTCCTGGCTT
AAAAAAAAACGTTGTCTCTAGGCT	GCACGGTTCGATTTAG
AAAAAAAAGCGTGTCCTCTAGGCT	GCACGGTTCGTGCCTT
AAAAAAAATTACTCCCTCTAGGCT	GCACGGTTCTAGCTTT
AAAAAAAAACCCAACTGCTATGTG	GCACTAAGTAATTAGC
AAAAAAAAGAAGTCATGCTATGTG	GCACTAAGTCAAACTG
AAAAAAAAGGGAGTAACGCCTACT	GCACTTACAGCATGAG
AAAAAAAATGCTACTACGCCTACT	GCACTTACATGCTCCC
AAAAAAAAGCTCGTTACTAGAAGG	GCAGCAACACCTATAG
AAAAAAAAGAACTGATGGCCAACT	GCAGCCAGTGATGATT
AAAAAAAATAATCCGTGGCCAACT	GCAGCCAGTTAACAGT
AAAAAAAACGGGTAATGGCCAACT	GCAGCCAGTTAGGCTA
AAAAAAAATACGTTACTTGGTTAT	GCAGGCTTCAAACTCA
AAAAAAAAGAAAGCCCTTGGTTAT	GCAGGCTTCAGGATGA
AAAAAAAATCTTGCTCTTGGTTAT	GCAGGCTTCAGTTCCC
AAAAAAAATTGCTTAGACATGCTC	GCAGGTGAGACAAAGT
AAAAAAAATCCCGGATGCAGGCAA	GCAGGTTGTAGTTAAC
AAAAAAAAGTGCGAGTGCAGGCAA	GCAGGTTGTATTGAGT
AAAAAAAATCGATCATGCAGGCAA	GCAGGTTGTCCACAAA
AAAAAAAAGGTTCACTGCAGGCAA	GCAGGTTGTCTATCGT
AAAAAAAAGTCGAGGTGCAGGCAA	GCAGGTTGTTAATGCG
AAAAAAAAGCAATAACTCGCCAAT	GCATATATCCAGGGAG
AAAAAAAATCTAGCGCTCGCCAAT	GCATATATCGCGCTAA
AAAAAAAAGTCCTGGCTCGCCAAT	GCATATATCGCTAGCA
AAAAAAAATTTAGTGCTCGCCAAT	GCATATATCTAAGTCA
AAAAAAAAACATTGCCTCAAACTT	GCATCCTTCAGAAACG
AAAAAAAATTCCTTGCTCAAACTT	GCATCCTTCCCGTTTA
AAAAAAAAGTAGTAACTCAAACTT	GCATCCTTCCTACCTA
AAAAAAAATGATTTGCTCAAACTT	GCATCCTTCGTTAAGC
AAAAAAAATAACTTCGAGGGTTTG	GCATGAAAGCCTGGTA
AAAAAAAAGGCGAGAGAGGGTTTG	GCATGAAAGGTCGATT
AAAAAAAATAGGCATGAGGGTTTG	GCATGAAAGGTGCGGA
AAAAAAAAACAGCCTTGATCCAAT	GCATTAGGTAGGATCC
AAAAAAAATGGCTATTGATCCAAT	GCATTAGGTTCACTGT
AAAAAAAATCAATGAACGTGGTTA	GCATTGCCACAAGCCT
AAAAAAAACGGGATTACGTGGTTA	GCATTGCCACATAGCC
AAAAAAAAGTTCAAGACGTGGTTA	GCATTGCCACCGGTAT
AAAAAAAACCTGCAACTTTGTGAT	GCCAACATCATTGACA
AAAAAAAATTAACACCTTTGTGAT	GCCAACATCTTTAGGA
AAAAAAAACCGATTATGGCAATTT	GCCAATAGTACCAGGT
AAAAAAAAAGGCCTTTGGCAATTT	GCCAATAGTGTGTGGT
AAAAAAAACAGCAAGTGGCAATTT	GCCAATAGTTCGCTTG
AAAAAAAAGCGAGAGGACCATATT	GCCAATTAGGTTACAC
AAAAAAAAAGCTAATGACCATATT	GCCAATTAGTGGACAA
AAAAAAAACTCATAACTTAATTGC	GCCACAATCATCCTGC
AAAAAAAACGATTGCCTTAATTGC	GCCACAATCATGTTTC
AAAAAAAAGTCAATCCTTAATTGC	GCCACAATCGCTATAA
AAAAAAAATACCGCACTTAATTGC	GCCACAATCTTGTCCA
AAAAAAAATCGACCTGAGGGAGCA	GCCACACAGGATCCGC
AAAAAAAAATAATGCGAACGGTAC	GCCACTAAGCAAGACA
AAAAAAAAGGAGGGTGAACGGTAC	GCCACTAAGGGCCATC
AAAAAAAAAATTGTGGAACGGTAC	GCCACTAAGGTCCAAT
AAAAAAAAGATTCCTGAACAGTAT	GCCAGGAAGGACCTCA
AAAAAAAAATATAGCGAACAGTAT	GCCAGGAAGTTAACCA
AAAAAAAAACAAGGCCTACTCCTC	GCCAGGTTCGATAACC
AAAAAAAAACGTTGTCTACTCCTC	GCCAGGTTCGATTTAG
AAAAAAAAGTAATGACTACTCCTC	GCCAGGTTCGGTTTGG
AAAAAAAATGTTCCTCTACTCCTC	GCCAGGTTCTGTTGCC
AAAAAAAACTAGCCACTAAAGCCG	GCCATGATCCTGAATA
AAAAAAAATGGTGTGACGAGGGAT	GCCATTACACAAAGGT
AAAAAAAACCTCAATACGAGGGAT	GCCATTACACAGCCTG
AAAAAAAATAACCGGACGAGGGAT	GCCATTACACGTAAGG
AAAAAAAACACCAACCTGAGTCTT	GCCCAAATCAATGTGC
AAAAAAAATGGCTCACTGAGTCTT	GCCCAAATCGATTCTT
AAAAAAAATGTGCACCTGAGTCTT	GCCCAAATCGCTAAAC
AAAAAAAACTATTGTGAGGTAGCT	GCCCATAAGACTAAGG
AAAAAAAAGTTAGCGGAGGTAGCT	GCCCATAAGCTTAGTA
AAAAAAAATCATGAGGAGGTAGCT	GCCCATAAGTTTGTCT
AAAAAAAAAGGCTAATGATTTAGC	GCCCGTTGTGATGAAA
AAAAAAAATGCAAGGTGATTTAGC	GCCCGTTGTTAGCGTA
AAAAAAAATTGGCTGCTCGCAACT	GCCCTCATCAAGCTTA
AAAAAAAAGGTTAATGACATCCTG	GCCTAATAGAACCTAC
AAAAAAAATGCAACAGACATCCTG	GCCTAATAGAGGCTAA
AAAAAAAACAAATGCGACATCCTG	GCCTAATAGCTGCACA
AAAAAAAACCGCTATGACATCCTG	GCCTAATAGTTGCGTG
AAAAAAAATGTATTGCTCCACCTC	GCCTACTTCATCACTT
AAAAAAAAAAAGGTTCTCCACCTC	GCCTACTTCGATCAGT
AAAAAAAATAGGTTTCTCCACCTC	GCCTACTTCGCTCACT
AAAAAAAAAACTAAGCTCCACCTC	GCCTACTTCGGGATTT
AAAAAAAACGCAAGGCTCCACCTC	GCCTACTTCTGCAACG
AAAAAAAAGGTTTATTGTAACACC	GCCTATTGTAGGTTGC
AAAAAAAAAGTTAGGTGTAACACC	GCCTATTGTATTTGCC
AAAAAAAATCCCTGTTGTAACACC	GCCTATTGTGACATGC
AAAAAAAACGGTTTATGTAACACC	GCCTATTGTTACTTCA
AAAAAAAAATGCATAGATCCTGTG	GCCTCAAAGGACAACA
AAAAAAAAACTCATGCTGGCTGCT	GCCTCCATCGTTTCTG
AAAAAAAAGAGAAACGACATATTC	GCCTGACAGGAAACTG
AAAAAAAAATGGGCGTGCTCACCT	GCCTGAGGTAGGTGTC
AAAAAAAAGGGTAGCTGGCTGAGG	GCCTGCTGTCCTAAGA
AAAAAAAATCTCTATTGGCTGAGG	GCCTGCTGTGCCTCAC
AAAAAAAACTAGTAAACCCGGAAT	GCCTGTGCAGTAAAGC
AAAAAAAAGATCAGTACCCGGAAT	GCCTGTGCATTAGCGC
AAAAAAAACCAAATAACAGATTGC	GCCTTAACAGATTCAT
AAAAAAAATGAGTGACTAGGCTAG	GCCTTACTCCTGGCTT
AAAAAAAACGCTTAGCTAGGCTAG	GCCTTACTCCTTCTAG
AAAAAAAAAGTTTGAGATTACGGA	GCCTTAGAGTAACCAC
AAAAAAAACCACAAAGATTACGGA	GCCTTAGAGTTGGGCC
AAAAAAAAGAACTGATGCATTTGG	GCCTTGCGTGATGATT
AAAAAAAAACCTACGTGCATTTGG	GCCTTGCGTTCCTCCT
AAAAAAAAGGTTTGTCTCCACAAC	GCCTTTATCACGCCAA
AAAAAAAAGGCCTCACTCCACAAC	GCCTTTATCATGCTTT
AAAAAAAACTTATGACTCCACAAC	GCCTTTATCGTGCTTC
AAAAAAAATGTCCTTCTCCACAAC	GCCTTTATCTACTAAG
AAAAAAAAGGGCGATTGAGCAAGT	GCCTTTGGTAGACAAA
AAAAAAAATTTATCCTGAGCAAGT	GCCTTTGGTCGCAAAC
AAAAAAAATGCGCCTACAGGCTTA	GCGAAGCCAATATACC
AAAAAAAACGCAAGCGAAATGAGG	GCGAAGTAGACTTACA
AAAAAAAAGCAATGCGAAATGAGG	GCGAAGTAGAGGAAGG
AAAAAAAATAGCACAGAAATGAGG	GCGAAGTAGGACCAGG
AAAAAAAAGGAGGGTGAAATGAGG	GCGAAGTAGGGCCATC
AAAAAAAAGGGCTATGAAATGAGG	GCGAAGTAGGTGAAGC
AAAAAAAACCGCTTAGAAATGAGG	GCGAAGTAGTAAAGGT
AAAAAAAATTGCCAGCTGACAGTG	GCGATATTCGCTAAGT
AAAAAAAAAATGAGCTGGCCAGTT	GCGATTAGTCCGCTGT
AAAAAAAAGGTAATGTGGCCAGTT	GCGATTAGTCGCAATA
AAAAAAAATACCTCCTGGCCAGTT	GCGATTAGTTAGACCA
AAAAAAAAGCAATGCGAACCAAAT	GCGATTTAGAGGAAGG
AAAAAAAAGATCCAGGAACCAAAT	GCGATTTAGCCGCTTT
AAAAAAAAAGCGATTACGTTTCTA	GCGCAAACAAGCTAAA
AAAAAAAAGTACGTAACGTTTCTA	GCGCAAACAATATAGG
AAAAAAAAAATTGCGACGTTTCTA	GCGCAAACAATGAGGT
AAAAAAAATATGATGACGTTTCTA	GCGCAAACATAGCTGC
AAAAAAAATATTGCGTGGCGGGAT	GCGCAATGTCACAGCG
AAAAAAAAATTGTCATGGCGGGAT	GCGCAATGTTACTAGG
AAAAAAAATTCACTTTGTTCATTC	GCGCCTTGTTAGCCAA
AAAAAAAATGGTTATCTACAAAGT	GCGCGATTCCTAAATG
AAAAAAAAAAATGGAACCTGATAA	GCGCTTGCAACCCTCC
AAAAAAAACGTGATGACCTGATAA	GCGCTTGCAATGAATG
AAAAAAAAAGTCACAACTCATAAG	GCGGAACCAAATATCC
AAAAAAAAGTACGTAACTCATAAG	GCGGAACCAATATAGG
AAAAAAAACCCAATTACTCATAAG	GCGGAACCACCATATG
AAAAAAAAATGGTCAACTTAACAG	GCGGATACAGTCTATG
AAAAAAAAAGTAGCGCTGCTATAC	GCGGTTATCTTAGGAC
AAAAAAAATACCGGCTGACAGAAC	GCGGTTGGTCGCGCAA
AAAAAAAATGGCTCACTCATGCCA	GCGTTTCTCGATTCTT
AAAAAAAACTTATGACTCATGCCA	GCGTTTCTCGTGCTTC
AAAAAAAAGGGAGGACTCATGCCA	GCGTTTCTCTCACATT
AAAAAAAACTATTGCACTTGTCCA	GCTAACCCAATATGGA
AAAAAAAAGAAACTCACTTGTCCA	GCTAACCCACCTCAGG
AAAAAAAACCTCCTCGATTATCAC	GCTAAGAAGGACAATG
AAAAAAAATAGGTACGATTATCAC	GCTAAGAAGGTAAGCA
AAAAAAAAGAAGTGAGATTATCAC	GCTAAGAAGTGATTCA
AAAAAAAAAGCTAATGATTATCAC	GCTAAGAAGTGGACAA
AAAAAAAAACAAGCGCTAACTCAC	GCTAAGTTCAATAGCC
AAAAAAAACCTTGTTCTAACTCAC	GCTAAGTTCATCCTCA
AAAAAAAAGCGGTAACTAACTCAC	GCTAAGTTCATGGTTA
AAAAAAAATCCAGCACTAACTCAC	GCTAAGTTCCTAACGG
AAAAAAAAGTGATGGCTAACTCAC	GCTAAGTTCTTGCTAT
AAAAAAAATGCGGGACTATTGGCT	GCTAATATCACACAGT
AAAAAAAACAGGGACCTATTGGCT	GCTAATATCCCGAACA
AAAAAAAAGACTAGGCTATTGGCT	GCTAATATCCCGCCTA
AAAAAAAACCAAGGGCTATTGGCT	GCTAATATCTTTGACT
AAAAAAAACAATTGAACTAACCTC	GCTAGCTCAACAACAA
AAAAAAAATGCTGTTACTAACCTC	GCTAGCTCAAGGATTA
AAAAAAAAGCACGGTACTAACCTC	GCTAGCTCACGAATTT
AAAAAAAATAACCGGACTAACCTC	GCTAGCTCACGTAAGG
AAAAAAAAGAAACCTACTAACCTC	GCTAGCTCAGGCATCT
AAAAAAAATATGCTCACTAACCTC	GCTAGCTCAGGGAGCT
AAAAAAAATGGCATGACTAACCTC	GCTAGCTCATAAGTCT
AAAAAAAATCCGGTACTCATGACC	GCTAGTGTCAATCATG
AAAAAAAAGGTTACCTGCTTATGG	GCTATAGGTAGCCATA
AAAAAAAAGTCGAGGTGCTTATGG	GCTATAGGTTAATGCG
AAAAAAAAGTTGAAGTGCTTATGG	GCTATAGGTTACCGGG
AAAAAAAATACGTTACTCCCGCTT	GCTATCCTCAAACTCA
AAAAAAAATCCGGTACTCCCGCTT	GCTATCCTCAATCATG
AAAAAAAAGGATTGGCTCCCGCTT	GCTATCCTCAGTGAAG
AAAAAAAACATGGTCCTCCCGCTT	GCTATCCTCATTACAG
AAAAAAAACTAACTACTCCCGCTT	GCTATCCTCCTGATGG
AAAAAAAAGACAAGCCTCCCGCTT	GCTATCCTCTCAATGA
AAAAAAAAGTAGCTAACAGCCGGT	GCTATTGCAAGGTAAC
AAAAAAAAAGCCGGTACAGCCGGT	GCTATTGCACAGACTC
AAAAAAAACGTTAGGACCTAACGG	GCTCAACCAAGCTTAT
AAAAAAAAAGCGTGCACCTAACGG	GCTCAACCAGAAACGT
AAAAAAAATCGAAGCACCTAACGG	GCTCAACCATTGTGGC
AAAAAAAACTACCGCACCTAACGG	GCTCAACCATTTGCTC
AAAAAAAAAACCTAAGACCAGGAC	GCTCACAAGAATCTCA
AAAAAAAATGTTGTTGACCAGGAC	GCTCACAAGACAACAG
AAAAAAAAGCACTAGGACCAGGAC	GCTCACAAGCTAATTG
AAAAAAAAAGTACCGGACCAGGAC	GCTCACAAGTATGTGC
AAAAAAAACATGGCGGATTGCTCG	GCTCCTTAGCACTAGT
AAAAAAAAGGAATAAACGGGCCAT	GCTCGATCAGTTATCG
AAAAAAAACAAACTAACGGGCCAT	GCTCGATCATGTCAGC
AAAAAAAACTGGTTTACCACAAAT	GCTCTGGCAGCCTAAC
AAAAAAAACCTCGCAACCACAAAT	GCTCTGGCATGTCAAT
AAAAAAAAGATCCTACTAGCGGAT	GCTCTGTTCAATTGGC
AAAAAAAAACAAACACTAGCGGAT	GCTCTGTTCAGCACCA
AAAAAAAAATATCGCCTAGCGGAT	GCTCTGTTCATAAGCC
AAAAAAAAGCGGTAACTAGCGGAT	GCTCTGTTCATGGTTA
AAAAAAAAAGATTGACTAGCGGAT	GCTCTGTTCCTCACTA
AAAAAAAAGTCCTAACTGTGAGAC	GCTGACATCCCATAAA
AAAAAAAAAATTAGGCTGTGAGAC	GCTGACATCTTGGATA
AAAAAAAACTTAGAAACAAAGGAT	GCTGATCCAGCCTGCA
AAAAAAAAACAATAGCTAGCCAGA	GCTGCAATCTAAATCG
AAAAAAAAGAAGTGAGACCGGTTT	GCTGCACAGTGATTCA
AAAAAAAAAGCTGTAACTCAATGA	GCTGCATCACGTTACA
AAAAAAAAGGTACGCACTCAATGA	GCTGCATCACTTCACT
AAAAAAAAAATCGTGACTCAATGA	GCTGCATCAGTTTCTC
AAAAAAAAGAATCACACTCAATGA	GCTGCATCATTGCGTA
AAAAAAAACTACTGATGGACTAAG	GCTGGATGTTACTTGC
AAAAAAAATTAAGGATGGACTAAG	GCTGGATGTTGGATCA
AAAAAAAACCTGGAAACGGGCGTT	GCTGGTTCAAAGCTAA
AAAAAAAAGTAGCTAACGGGCGTT	GCTGGTTCAAGGTAAC
AAAAAAAACAGGACTACGGGCGTT	GCTGGTTCAATTGAAG
AAAAAAAAGTGCTGGACGGGCGTT	GCTGGTTCACCCACCT
AAAAAAAATGACAATACGGGCGTT	GCTGGTTCACCTCACC
AAAAAAAACGAATATACGGGCGTT	GCTGGTTCACCTGCCT
AAAAAAAAGTCAATGACGGGCGTT	GCTGGTTCATTGCGGT
AAAAAAAATGTGAGGTGAGCCACT	GCTGTAAGTTAGAGCC
AAAAAAAACGGGTAATGAGCCACT	GCTGTAAGTTAGGCTA
AAAAAAAATGTAACCTGAGCCACT	GCTGTAAGTTGCCTCA
AAAAAAAAGCGTCTATGAGCCACT	GCTGTAAGTTTGAGCA
AAAAAAAACTTAGCTACGCCACTT	GCTGTACCAAAGGTAC
AAAAAAAACACACCCACGCCACTT	GCTGTACCACAATTAC
AAAAAAAAGGTACTAACGCCACTT	GCTGTACCAGTCTAAT
AAAAAAAACCCTGTGACGCCACTT	GCTGTACCATGAGTTT
AAAAAAAAGACTAGGCTTAGGTAG	GCTGTGATCCCGCCTA
AAAAAAAATGGTTATCTTAGGTAG	GCTGTGATCCTAAATG
AAAAAAAAATAGCGGCTTAGGTAG	GCTGTGATCGTTTCCA
AAAAAAAAGCAAATACTTAGGTAG	GCTGTGATCTCGACCT
AAAAAAAACAAGCCTCTTAGGTAG	GCTGTGATCTGTGCCT
AAAAAAAAACTAAGACTTAGGTAG	GCTGTGATCTTAGCCC
AAAAAAAATAAGGTCGAACCTTTG	GCTGTGCAGCCTGACA
AAAAAAAACGTAAAGCTCGATAAG	GCTTAAATCAATGTCA
AAAAAAAACAACCTGCTCGATAAG	GCTTAAATCGCGACAC
AAAAAAAACTAGACCCTCGATAAG	GCTTAAATCTTAGCGG
AAAAAAAACGTAAAGCTTTGTGGC	GCTTACCTCAATGTCA
AAAAAAAATTCGTAACTTTGTGGC	GCTTACCTCTATGACA
AAAAAAAAACGATTAGACTTAATC	GCTTAGTAGTGAGCAA
AAAAAAAACGCAACCTGAGTGAGT	GCTTATCGTAGCTGGT
AAAAAAAAGATTTGGACATGCTCC	GCTTGACCAATTAGCT
AAAAAAAAAGCGTGCACATGCTCC	GCTTGACCAGAAACGT
AAAAAAAAGGTTAACACATGCTCC	GCTTGACCATTATGCG
AAAAAAAATTCCCGTTGAAGCCAA	GCTTGTTGTAATCGCA
AAAAAAAACCAGGAATGAAGCCAA	GCTTGTTGTCATGCCC
AAAAAAAAGCTCCCTTGAAGCCAA	GCTTGTTGTCTCACTG
AAAAAAAATAAAGCATGAAGCCAA	GCTTGTTGTGCTCCAC
AAAAAAAACTCCTCATGTTTCAGG	GCTTTACGTCACGAAC
AAAAAAAAGAATGCATGTTTCAGG	GCTTTACGTTAGCATG
AAAAAAAATGCTCTCTGTTTCAGG	GCTTTACGTTGCTTCG
AAAAAAAATGTTGGCCTCCATAAT	GCTTTATTCACTAGGT
AAAAAAAAAGTCCCGCTCCATAAT	GCTTTATTCCTGCGAA
AAAAAAAAATAGATGCTCCATAAT	GCTTTATTCTACCTGC
AAAAAAAACCGTTAGCTGGTCTTA	GCTTTCATCACAAGCT
AAAAAAAACCATGACCTGGTCTTA	GCTTTCATCATGCAAC
AAAAAAAATAGCAAGCTGGTCTTA	GCTTTCATCATTAGGC
AAAAAAAAAGATTGACTGGTCTTA	GCTTTCATCCTCACTA
AAAAAAAAAGCCAAATGCTTAACG	GCTTTGTGTTCTTTAG
AAAAAAAATTGCATGTGCTTAACG	GCTTTGTGTTTGGTTC
AAAAAAAACGAGGTTACTTCGTCA	GGAAACTCACAACCTA
AAAAAAAACTAGTAAACTTCGTCA	GGAAACTCAGTAAAGC
AAAAAAAATTGCTCTCTTAGGCGG	GGAACAATCACATTGA
AAAAAAAATCAAATCCTTAGGCGG	GGAACAATCCGGAACC
AAAAAAAACTTAATGCTTAGGCGG	GGAACAATCTTAGGGT
AAAAAAAAGTAGCTAACATGAAAG	GGAACCACAAGGTAAC
AAAAAAAATTAAAGCACATGAAAG	GGAACCACATAATCCG
AAAAAAAATTCACTGACATGAAAG	GGAACCACATCCTGAA
AAAAAAAATACCTGATGCCTATTT	GGAACCTGTCCGTAGG
AAAAAAAACAAGGGTTGCCTATTT	GGAACCTGTTTGTGGA
AAAAAAAAACACTTGCTTGCTGCA	GGAACGGTCAACAAGG
AAAAAAAACGCCTCTCTTGCTGCA	GGAACGGTCAGGAACA
AAAAAAAAATTGCGGGAGGCATGT	GGAACTAAGACAAACG
AAAAAAAAGAATTTGGAGGCATGT	GGAACTAAGCATTTCT
AAAAAAAAAGTGTGCGAGGCATGT	GGAACTAAGCTTACTT
AAAAAAAAGCCAACAGAGGCATGT	GGAACTAAGGTCTTGG
AAAAAAAATTTGCAACTATCCTAG	GGAAGTATCAATGAGG
AAAAAAAAGGTGTGACTATCCTAG	GGAAGTATCCAAGTGT
AAAAAAAAGCCATGCCTATCCTAG	GGAAGTATCTCACAAA
AAAAAAAACGGAGCACTCAATTAC	GGAATCTTCCTAGTAA
AAAAAAAATGATTTGCTCAATTAC	GGAATCTTCGTTAAGC
AAAAAAAATGGTCCACTCAATTAC	GGAATCTTCTTAGTGA
AAAAAAAAAGACTCAACAAGAACA	GGACAGCCAATGCCCG
AAAAAAAAGTTGTCCACAAGAACA	GGACAGCCAGCGCTTG
AAAAAAAAGTGGTGCACAAGAACA	GGACAGCCATAAACCT
AAAAAAAAGATGAAGGAGTCATTC	GGACATAAGCCTGAGC
AAAAAAAACATGTTTGAGTCATTC	GGACATAAGTCCTGAG
AAAAAAAAAGGATTTGAGTATGTA	GGACCTCAGTTTGAGC
AAAAAAAAGTCCTGATGCTGAGAG	GGACGAAGTCACCTAT
AAAAAAAAAATGAGCTGCTGAGAG	GGACGAAGTCCGCTGT
AAAAAAAACGTGCTGTGCTGAGAG	GGACGAAGTTTAGCGA
AAAAAAAACGATTGCCTGCTAATC	GGACGGATCATGTTTC
AAAAAAAACTTTAAGCTGCTAATC	GGACGGATCCAATTAG
AAAAAAAACAAGCTCCTGCTAATC	GGACGGATCCATAAGC
AAAAAAAAGTTAGCGGATCCCTTT	GGACTAAAGCTTAGTA
AAAAAAAACGTTATTGATCCCTTT	GGACTAAAGGCTTAAC
AAAAAAAAACATTAGGATCCCTTT	GGACTAAAGTTCCCGT
AAAAAAAATGCGCTTGATCCCTTT	GGACTAAAGTTTAACG
AAAAAAAAGAGGCACTGTTTGGTG	GGAGCAAGTAAAGCAA
AAAAAAAATTTAGGCTGTTTGGTG	GGAGCAAGTGGAGCAA
AAAAAAAATCGTGACCTTGCTGGT	GGAGCGATCCTAATAG
AAAAAAAACCCAGCATGCTTTAGG	GGAGTGAGTTAATGAC
AAAAAAAAACATGTTTGCTTTAGG	GGAGTGAGTTCCTGTG
AAAAAAAAGGTTGTTCTGCCACAC	GGATACTTCCAACTGG
AAAAAAAATGGTTATCTGCCACAC	GGATACTTCCTAAATG
AAAAAAAAAGGCCTTTGAGCGATA	GGATATTGTGTGTGGT
AAAAAAAATCCCTCATGAGCGATA	GGATATTGTTCCGCAC
AAAAAAAAATGGCCTTGAGCGATA	GGATATTGTTTATCGC
AAAAAAAAACCATACCTTACGTGC	GGATGAATCATGGCCA
AAAAAAAAGCGACTCCTTACGTGC	GGATGAATCGCTATGG
AAAAAAAAAGTAACCACTCAGGCA	GGATGGCCACTTGTTC
AAAAAAAAACTGCAAACTCAGGCA	GGATGGCCAGTTATGT
AAAAAAAAGATCAGTACTCAGGCA	GGATGGCCATTAGCGC
AAAAAAAATATTACCGAGCAATAT	GGATGTAAGCTCAAAC
AAAAAAAAAAGGTTTGAGCAATAT	GGATGTAAGGCTTAGT
AAAAAAAATCTATGTGAGCAATAT	GGATGTAAGGGTGAGT
AAAAAAAACTTTAGGTGAGTAACG	GGATTATGTAAGCTTG
AAAAAAAAATTGAGGTGACAGCCT	GGATTCAGTGTGAGAG
AAAAAAAAGGGTAATTGAGGTTAG	GGATTGCGTTCAAGAT
AAAAAAAATTTCGTCCTCACACTG	GGATTTATCATGGCTG
AAAAAAAAAGAACCTACCTGGTGA	GGCAAATCAATAATCC
AAAAAAAAGTGGTTAACCTGGTGA	GGCAAATCACTCAACA
AAAAAAAAGTCCATCACCTGGTGA	GGCAAATCATTCCTGT
AAAAAAAACGATTCATGAGGGACC	GGCAATCGTTACCTGT
AAAAAAAAAACGTAACTCAGCAAA	GGCAGGATCGGTAACT
AAAAAAAACCCTCCTGACTAATTC	GGCATGGAGACACCGC
AAAAAAAAAAGCTCCTGCTCAGTA	GGCATTAGTAACCAGC
AAAAAAAACAGGCCTTGCTCAGTA	GGCATTAGTCATGAGC
AAAAAAAAAGGCTAATGCTCAGTA	GGCATTAGTGATGAAA
AAAAAAAACCTAGCGTGCTCAGTA	GGCATTAGTTAGGACC
AAAAAAAAAGCCTGTTGCTCAGTA	GGCATTAGTTAGTACG
AAAAAAAATGAGTGACTACTAACC	GGCATTGTCCTGGCTT
AAAAAAAAGCAAATACTAGCACGA	GGCCAACTCTCGACCT
AAAAAAAATTTAAGCCTAGCACGA	GGCCAACTCTTGAGGT
AAAAAAAAAATTGTGGATATTCGT	GGCCATCAGGTCCAAT
AAAAAAAAGTGAAGCCTTCCAGGT	GGCCTAATCCTAAGGT
AAAAAAAAAAGGAAGCTTCCAGGT	GGCCTAATCTTGCAGG
AAAAAAAAAGATGCATGTTGACCA	GGCCTCTGTTCGGGAT
AAAAAAAAGTTACCTGAGCTTAAA	GGCCTTAAGGATTGCT
AAAAAAAAGCCGATAGAGCTTAAA	GGCCTTAAGTAACGAG
AAAAAAAAATATAGCGAGCTTAAA	GGCCTTAAGTTAACCA
AAAAAAAACTTCGCTTGCAAGCGA	GGCCTTCGTTAGGATT
AAAAAAAAACTGACAACATAGACC	GGCGATACACAGGAAT
AAAAAAAAATAAAGGACATAGACC	GGCGATACACTAGGTC
AAAAAAAACTAGTCTACATAGACC	GGCGATACAGTTTACG
AAAAAAAACAAACTAACATAGACC	GGCGATACATGTCAGC
AAAAAAAACAATCCATGAGCTGGG	GGCGCTAGTCCAAATG
AAAAAAAAGTGAAGCCTTGACTTA	GGCGGTTTCCTAAGGT
AAAAAAAAAGCTTACCTTGACTTA	GGCGGTTTCCTTGTTG
AAAAAAAATGTGTTACTATGATGA	GGCGTTATCACAGCCA
AAAAAAAAGGATTGGCTATGATGA	GGCGTTATCAGTGAAG
AAAAAAAAAGAACCGCTATGATGA	GGCGTTATCTCACACC
AAAAAAAATGAGGAAACGTTGTAG	GGCTAGACAACACCTA
AAAAAAAATGCTACTACGTTGTAG	GGCTAGACATGCTCCC
AAAAAAAATTTGCAACTAACCGGA	GGCTATGTCAATGAGG
AAAAAAAAGTTAACCCTAACCGGA	GGCTATGTCATTACTC
AAAAAAAATGCGTGTCTAACCGGA	GGCTATGTCCTGGTGA
AAAAAAAAGGTTGGTGAAACCGCA	GGCTATTAGAAGGTGC
AAAAAAAAAGAGCAAGAAACCGCA	GGCTATTAGGAAGTAT
AAAAAAAATTTGCAACTCAGGAGC	GGCTCAATCAATGAGG
AAAAAAAATCCCACCCTCAGGAGC	GGCTCAATCTGGCAAT
AAAAAAAACTGGCAGGACATGCAA	GGCTCACAGCCTCTCG
AAAAAAAACGAGCTGGACATGCAA	GGCTCACAGTATTGCA
AAAAAAAAACACCTTGACATGCAA	GGCTCACAGTTGTCTT
AAAAAAAAGATAATCGAGGAACGG	GGCTGAGAGTCACTAA
AAAAAAAATGCAAGACTGTTGCAT	GGCTGGTTCAACCAAC
AAAAAAAAAGTTGTCCTGTTGCAT	GGCTGGTTCAATTACG
AAAAAAAAGTGCAAGCTGTTGCAT	GGCTGGTTCCGCCTAT
AAAAAAAACATTTGTGAGTAACTA	GGCTGTCAGTCACCAG
AAAAAAAAATTTGGTTGTCATCAG	GGCTTAAGTCAGTAAT
AAAAAAAAAACTGATGACCGGTGA	GGCTTCAAGCATCCAG
AAAAAAAAGCGCAATGACCGGTGA	GGCTTCAAGGGTGGAT
AAAAAAAAGGTTGTTCTCAGCTAC	GGGAATATCCAACTGG
AAAAAAAATCGGTACCTCAGCTAC	GGGAATATCCAGGAAA
AAAAAAAAGACCAAGCTCAGCTAC	GGGAATATCCATTACT
AAAAAAAAAACGGACCTCAGCTAC	GGGAATATCCTAGTTT
AAAAAAAATTAAGTCCTCAGCTAC	GGGAATATCGGTTACG
AAAAAAAACTACTAACTCAGCTAC	GGGAATATCTGTTCAT
AAAAAAAAGCTGGTTTGCGTACCG	GGGAGTAGTACTGAAT
AAAAAAAATTGTTGGTGCGTACCG	GGGAGTAGTAGGTTTG
AAAAAAAATAAGCCTTGCGTACCG	GGGAGTAGTTCATTTG
AAAAAAAAGTTAGTAGAGCTTATC	GGGATTAAGAGGAGTC
AAAAAAAAAGAGCAAGAGCTTATC	GGGATTAAGGAAGTAT
AAAAAAAATAGCCCTGAGCTTATC	GGGATTAAGTGAACCT
AAAAAAAAGAGGTGGGACCTTGTG	GGGCAATAGAGGGACT
AAAAAAAAGATCCAGGACCTTGTG	GGGCAATAGCCGCTTT
AAAAAAAATGGGCGTGACCTTGTG	GGGCAATAGGCGAAAC
AAAAAAAAGCACTAGGAAATTACG	GGGCATGAGCTAATTG
AAAAAAAAGATTAGTGAAATTACG	GGGCATGAGCTTATGA
AAAAAAAATGCTTATGAAATTACG	GGGCATGAGTAAACCC
AAAAAAAAGACCTAGGAAATTACG	GGGCATGAGTAAGTCC
AAAAAAAAGGTTACCTGGCAATAG	GGGCATTGTAGCCATA
AAAAAAAAGTTCCTTTGGCAATAG	GGGCATTGTGGTTATG
AAAAAAAAACCATTATGGCAATAG	GGGCATTGTTTATCTG
AAAAAAAAACTAGTTTGTCCTGAA	GGGCCTAGTCTAACCT
AAAAAAAAGTTTGGCTGTCCTGAA	GGGCCTAGTGATCAGC
AAAAAAAAAGGCTAATGTCCTGAA	GGGCCTAGTGATGAAA
AAAAAAAATGCTGTTACTAAGGTT	GGGCTAACAAGGATTA
AAAAAAAATCCTCCTACTAAGGTT	GGGCTAACATAATCAC
AAAAAAAACAGGATCACTAAGGTT	GGGCTAACATCTTGAG
AAAAAAAAACCGGACACTAAGGTT	GGGCTAACATTAGGCC
AAAAAAAATCGCAACCTAGCTACT	GGGTATTTCGTAATCA
AAAAAAAAGTGCTGGACGATTCTT	GGGTCAACACCCACCT
AAAAAAAACTATTAGCTACTCACA	GGGTCACTCCAAGTTA
AAAAAAAAAGTCAAACTACTCACA	GGGTCACTCGACCTGA
AAAAAAAAGTCCTGATGGACCTTG	GGGTTACGTCACCTAT
AAAAAAAAGATTGCTCTTCAATAC	GGGTTATTCCTTGCAC
AAAAAAAACTTAAGAACCCGCTCA	GGGTTTCCATAATTGC
AAAAAAAACAATTTGCTAGGATGC	GGGTTTGTCTAACCTT
AAAAAAAAGTGTAACACTCACAAA	GGTAAACCAACACTTG
AAAAAAAATTTGGAAACTCACAAA	GGTAAACCACCAAAGG
AAAAAAAATCCAACATGTTGAGCT	GGTAACCGTCAAAGAA
AAAAAAAAATAGTGACTCGCAATC	GGTAACTTCCGCATGA
AAAAAAAAGATTCACCTCGCAATC	GGTAACTTCCTCATGC
AAAAAAAATCAAACCTGAAGCCCT	GGTAAGGGTAGCTGCG
AAAAAAAACCTTTATTGAAGCCCT	GGTAAGGGTCATCCTG
AAAAAAAAAGTACCGGAGGCTTGA	GGTACAAAGTATGTGC
AAAAAAAAGTACTGGGAGGCTTGA	GGTACAAAGTCTGGGC
AAAAAAAACGGAAACTGTTTGTGG	GGTACCGGTTAACGAT
AAAAAAAATGCTTAGTGATCCTTC	GGTACTAGTCAACAAT
AAAAAAAAGCTGTCATGATCCTTC	GGTACTAGTCAAGTAT
AAAAAAAATGGAGCATGATCCTTC	GGTACTAGTCATTGAG
AAAAAAAAGAATTTGGATCACAGA	GGTACTTAGCATTTCT
AAAAAAAACATAACGGATCACAGA	GGTACTTAGGGACCTC
AAAAAAAAGGTAGCTGATCACAGA	GGTACTTAGTCTTGAA
AAAAAAAAATATAGCGATCACAGA	GGTACTTAGTTAACCA
AAAAAAAAACCACGTTGAACGGTA	GGTAGGAGTAATCACG
AAAAAAAACAATACCTGAACGGTA	GGTAGGAGTCAGGAAG
AAAAAAAAAGCTAAGTGAACGGTA	GGTAGGAGTCCTTAGT
AAAAAAAACGGTTTATGAACGGTA	GGTAGGAGTTACTTCA
AAAAAAAAGGAGGCTTGAACGGTA	GGTAGGAGTTCAAGCA
AAAAAAAATAGCTTACTGTGAGCA	GGTATGTTCAATCTAG
AAAAAAAACTACTGATGATTGACT	GGTATTGGTTACTTGC
AAAAAAAAGGTATTGACGCTAACA	GGTATTTCACAAACTT
AAAAAAAAATTCATCACGCTAACA	GGTATTTCACGCAACT
AAAAAAAAGATCATGACTCCCTGG	GGTCAAGCAAAGCTCC
AAAAAAAAAACGCTAACTCCCTGG	GGTCAAGCAAGTAAGC
AAAAAAAAGAACCTAACTCCCTGG	GGTCAAGCAGCTTACA
AAAAAAAACTAACTCACTCCCTGG	GGTCAAGCATGTCGCG
AAAAAAAAAAGCACGCTTGCTCAG	GGTCAATTCAGGAAGC
AAAAAAAACCCTAAGCTTGCTCAG	GGTCAATTCTCAATTC
AAAAAAAACTACTAACTTGCTCAG	GGTCAATTCTGTTCAT
AAAAAAAATATTACCGATTAGCTT	GGTCAGGAGCTCAAAC
AAAAAAAATCCGCATGAGCGGTTA	GGTCATTAGGTAACGA
AAAAAAAAAACGATTGAGCGGTTA	GGTCATTAGGTTAGAG
AAAAAAAATCAGGACACAAGCGCC	GGTCCATCAATAGTCT
AAAAAAAACCACTTAACAAGCGCC	GGTCCATCACATTGCA
AAAAAAAAGGCCAGTACAAGCGCC	GGTCCATCACCAACCG
AAAAAAAAGGGAGTAACAAGCGCC	GGTCCATCAGCATGAG
AAAAAAAAGTAATGTGATTAGCGA	GGTCCGTAGGAGGACT
AAAAAAAATTCGCGCACAAAGGCG	GGTCCTGCAAACCTAT
AAAAAAAAATAGCTCCTCAACCGT	GGTCGGTTCCTTAATC
AAAAAAAAACCCGCACTCAACCGT	GGTCGGTTCTTGCATT
AAAAAAAATGAGCGCGATCGCTCA	GGTCTTGAGCTAATCA
AAAAAAAATGGGCGTGATCGCTCA	GGTCTTGAGGCGAAAC
AAAAAAAAGATTGCGGATCGCTCA	GGTCTTGAGTGAACAG
AAAAAAAAAAGCTCCTGCGACATT	GGTCTTTGTAACCAGC
AAAAAAAAACTAAGGTGCGACATT	GGTCTTTGTATTACCC
AAAAAAAAAGGCGCATGCGACATT	GGTCTTTGTATTTGGG
AAAAAAAAAGGCGGTTGCGACATT	GGTCTTTGTGATTACG
AAAAAAAAGCAACTAACCGCACAA	GGTGAGCCAACTAGGG
AAAAAAAAGGTTACAACCGCACAA	GGTGAGCCAATACTGT
AAAAAAAATGTCAGGACCGCACAA	GGTGAGCCAGGTTCAC
AAAAAAAAGGTTTGTCTCACAAAG	GGTGAGGTCACGCCAA
AAAAAAAAGCTTCATGATAACGGT	GGTGAGTAGTTATTCC
AAAAAAAAGTTGACGGATAACGGT	GGTGAGTAGTTCCTGC
AAAAAAAATCTTGCTCTCCCAAAC	GGTGATTTCAGTTCCC
AAAAAAAATCCATCCTGTCCAAAC	GGTGCTGGTATTCGCT
AAAAAAAAAGTCACCTGTCCAAAC	GGTGCTGGTTAGGTGC
AAAAAAAACGATATAACAGCTAAC	GGTGCTTCAATTTAGC
AAAAAAAACCGTTTAACAGCTAAC	GGTGCTTCACTGACTA
AAAAAAAACTTCATGACAGCTAAC	GGTGCTTCAGGCCTTG
AAAAAAAACATGGTGACAGCTAAC	GGTGCTTCATACCCGG
AAAAAAAAGGTTATGACAGCTAAC	GGTGCTTCATGAGCAG
AAAAAAAAGGCTCCTGACTTCGAC	GGTGTCCAGTATTGTG
AAAAAAAAGTGGCCAACCGTTACT	GGTGTGACAAGTTATC
AAAAAAAATACGTGCCTTTGGTTA	GGTGTTGTCAGGCTAT
AAAAAAAACGCTTAGCTTTGGTTA	GGTGTTGTCCTTCTAG
AAAAAAAATTAACACCTTTGGTTA	GGTGTTGTCTTTAGGA
AAAAAAAAAGTAGGTTGACATTGT	GGTTAATGTCGCATAA
AAAAAAAAAGGCTAATGACATTGT	GGTTAATGTGATGAAA
AAAAAAAACAGTCTATGACATTGT	GGTTAATGTGTTTGAG
AAAAAAAACTGACATTGACATTGT	GGTTAATGTTGGATAT
AAAAAAAACATAAGTACGGATCGC	GGTTACCCAAATTCGT
AAAAAAAAAACGCTAACGGATCGC	GGTTACCCAAGTAAGC
AAAAAAAATCCCTCTACGGATCGC	GGTTACCCAATCATGT
AAAAAAAAAAACCGTACGGATCGC	GGTTACCCAGCCAGTT
AAAAAAAATTTCCGGGAGCGAACT	GGTTACTAGCCAGTAT
AAAAAAAACGCGAAATGCACCTAA	GGTTAGCGTACCTTAC
AAAAAAAAGTTGCACTGCACCTAA	GGTTAGCGTCAAGACC
AAAAAAAATTGCGCGTGCACCTAA	GGTTAGCGTCAATACG
AAAAAAAATTGAAGGCTAGGTTAA	GGTTATATCGCCTGTT
AAAAAAAAACCAATCCTAGGTTAA	GGTTATATCGCTTCTA
AAAAAAAATTAAGTCCTAGGTTAA	GGTTATATCGGTTACG
AAAAAAAAAAGAACCTGGACGAAT	GGTTATGGTAATGGAA
AAAAAAAATGACAAATGGACGAAT	GGTTATGGTTTAACGG
AAAAAAAATGGCTTATGCAAACCT	GGTTCTTGTGCGCAAT
AAAAAAAACTGGTTATGCAAACCT	GGTTCTTGTGCTGTAA
AAAAAAAAGAATGCATGCAAACCT	GGTTCTTGTTAGCATG
AAAAAAAAATTTGGTTGCCTGCAG	GGTTGACGTCAGTAAT
AAAAAAAAACAGAATCTTCACCAG	GGTTGCATCGATATTG
AAAAAAAAAGTGAGGACTGACTAA	GGTTGCTCAATAGCAA
AAAAAAAATCCAACTACTGACTAA	GGTTGCTCAGACAAAC
AAAAAAAATTCACCAACTGACTAA	GGTTGCTCATTCCTCG
AAAAAAAAGTTGCACTGTTCCATT	GGTTGGTGTCAAGACC
AAAAAAAACAGCATTTGTTCCATT	GGTTGGTGTGAACAAA
AAAAAAAATCCTCTACTCACCACA	GGTTTAATCGCACACA
AAAAAAAAAGGGTTGCTAAATACG	GGTTTCCTCTATTGTC
AAAAAAAAGATTGAGTGCAGGTCC	GGTTTCTGTACAATGT
AAAAAAAAAGAAACCTGCAGGTCC	GGTTTCTGTCATTAGG
AAAAAAAAGACATCCTGCAGGTCC	GGTTTCTGTCTAACAG
AAAAAAAAAGTCACCTGCAGGTCC	GGTTTCTGTTAGGTGC
AAAAAAAATAGCATGGAACAGATT	GGTTTGTAGCAGCTAT
AAAAAAAAACGGATCGAACAGATT	GGTTTGTAGCCACAAT
AAAAAAAATGCAAGTGAACAGATT	GGTTTGTAGTATTGGC
AAAAAAAAGCAGTTAACATAACGC	GTAAAGCCAACTAGAA
AAAAAAAATCACCATACATAACGC	GTAAAGCCAAGACTCC
AAAAAAAACTCCATAACATAACGC	GTAAAGCCAAGATTCT
AAAAAAAACTTAACCACATAACGC	GTAAAGCCAATTAGGA
AAAAAAAACTTACGTACATAACGC	GTAAAGCCATCCGTAA
AAAAAAAAGTTAGTAGAACTAAGT	GTAAGCAAGAGGAGTC
AAAAAAAATAGGCTAGAACTAAGT	GTAAGCAAGGAAGCAC
AAAAAAAACAGGACTACAGCCATA	GTAAGCGCAATTGAAG
AAAAAAAATGAACCGACAGCCATA	GTAAGCGCACATACTG
AAAAAAAATAGGAGTCTAGCCACC	GTAAGCTTCACTAATG
AAAAAAAAATATCGCCTAGCCACC	GTAAGCTTCATAAGCC
AAAAAAAAGCGCTAGACCGGTTGA	GTAAGGTCAAGGTACG
AAAAAAAAATAAAGGACCGGTTGA	GTAAGGTCACTAGGTC
AAAAAAAAACCTGCTACCGGTTGA	GTAAGGTCATTGCGAC
AAAAAAAAGTAAGCTACCAAAGCC	GTAATAGCAACCTAAT
AAAAAAAAGAGCTATACCAAAGCC	GTAATAGCAGTACCGT
AAAAAAAATTAAAGCACCAAAGCC	GTAATAGCATAATCCG
AAAAAAAACAGTAATACCTCGCAC	GTACACCCAAATGCCC
AAAAAAAACTGTTACACCTCGCAC	GTACACCCAACAGGTG
AAAAAAAAGAGCGCTACCTCGCAC	GTACACCCAACCTGGT
AAAAAAAAAATTGCGACCTCGCAC	GTACACCCAATGAGGT
AAAAAAAACACCATTACCTCGCAC	GTACACCCATGCATAT
AAAAAAAACGCATTATGAAGGACT	GTACCGGGTGGATTAT
AAAAAAAAACGTATTTGCTCTCTG	GTACCTTGTACCGTTT
AAAAAAAAGTGCGAGTGCTCTCTG	GTACCTTGTATTGAGT
AAAAAAAAGCATATTTGCTTCATT	GTACGTAGTAAACAAG
AAAAAAAACTCAGGCTGCTTCATT	GTACGTAGTAATCCCT
AAAAAAAAAAGGTCATGCTTCATT	GTACGTAGTCATAAGT
AAAAAAAAAACTTCGCTAAGCCTT	GTACTAATCAGCATTA
AAAAAAAAATACCTGCTAAGCCTT	GTACTAATCATAACTG
AAAAAAAACCTGCAACTAAGCCTT	GTACTAATCATTGACA
AAAAAAAAGTGGTGACTAAGCCTT	GTACTAATCCGCCTCA
AAAAAAAAAAACTAGCTAAGCCTT	GTACTAATCGCATTAA
AAAAAAAAACTAAGGTGCGCAGTC	GTACTAGGTATTACCC
AAAAAAAATGTATTGCTACATAAG	GTACTGGTCATCACTT
AAAAAAAACGCAAGGCTACATAAG	GTACTGGTCTGCAACG
AAAAAAAAGATCCAGGAGGCGGAA	GTACTTAAGCCGCTTT
AAAAAAAACCGGTTTGAGGCGGAA	GTACTTAAGCGCATTG
AAAAAAAAAGTACCGGAGGCGGAA	GTACTTAAGTATGTGC
AAAAAAAATTACCCGGAGGCGGAA	GTACTTAAGTGAGAGC
AAAAAAAAGGCAATATGAACCTAT	GTACTTCGTAGGATTT
AAAAAAAATACGCACCTTGTTATG	GTAGCGCTCACTCAAA
AAAAAAAACGTGAAACTATATCGC	GTAGCTGTCAAGGACA
AAAAAAAATGCTATACTATATCGC	GTAGCTGTCAGCTAAC
AAAAAAAATGTGCACCTATATCGC	GTAGCTGTCGCTAAAC
AAAAAAAAATAGATGCTATATCGC	GTAGCTGTCTACCTGC
AAAAAAAATGACAAATGTCATGCA	GTAGGAGGTTTAACGG
AAAAAAAAGTAATCGACCTTACGT	GTAGGATCAACAGCCT
AAAAAAAATTGTTGCACCTTACGT	GTAGGATCAGAGGGAG
AAAAAAAATGGTTAGGAGGCACTA	GTAGGCGAGGAACCGG
AAAAAAAATAGGTACGAGGCACTA	GTAGGCGAGGTAAGCA
AAAAAAAAGGTGTTAACGATAACC	GTAGGTGCAGGTTAAA
AAAAAAAACCGGATAACGATAACC	GTAGGTGCATGAATAG
AAAAAAAAGCAATTGACGATAACC	GTAGGTGCATTGACAT
AAAAAAAAAAAGTGAACGATAACC	GTAGGTGCATTTAAGC
AAAAAAAAAGAGCTGCTTAGCGGG	GTAGTTATCAAGTGAG
AAAAAAAAGTGTTTGCTTAGCGGG	GTAGTTATCACCAATA
AAAAAAAATCCATAACTTAGCGGG	GTAGTTATCAGCACGC
AAAAAAAAGGCGATACTTAGCGGG	GTAGTTATCATCCTAT
AAAAAAAACGATAAGCTTAGCGGG	GTAGTTATCCCATAGG
AAAAAAAATTTCAAGCTTAGCGGG	GTAGTTATCCTAATTC
AAAAAAAACTTGTTCCTTAGCGGG	GTAGTTATCGATTATG
AAAAAAAAGATCATGACGAATCCA	GTAGTTTCAAAGCTCC
AAAAAAAACTCTATGACGAATCCA	GTAGTTTCACACCAAC
AAAAAAAAACAAAGAACGAATCCA	GTAGTTTCATAATCGT
AAAAAAAAGGTTATGACGAATCCA	GTAGTTTCATGAGCAG
AAAAAAAAGTAAGCTACGCCCAGA	GTATCGCCAACCTAAT
AAAAAAAAAGAAATGACGCCCAGA	GTATCGCCACTTAGGC
AAAAAAAATATGATGACGCCCAGA	GTATCGCCATAGCTGC
AAAAAAAACTACTAGTGGTGCACT	GTATGTGGTCCAAGAC
AAAAAAAACAGCATTTGGTGCACT	GTATGTGGTGAACAAA
AAAAAAAAGCGGTCAACCCAGCAA	GTATGTTCAACCGCCA
AAAAAAAATCTTGCAACCCAGCAA	GTATGTTCAGGCTTGT
AAAAAAAACTAGTAAACCCAGCAA	GTATGTTCAGTAAAGC
AAAAAAAAACAAAGAACCCAGCAA	GTATGTTCATAATCGT
AAAAAAAACTGATTTGAGCTAACG	GTATTCAAGCTTTGTT
AAAAAAAAAGGTTATGAGCTAACG	GTATTCAAGGACCGCT
AAAAAAAAGCATCCCGAGCTAACG	GTATTCAAGGCAGGTG
AAAAAAAACTTGACCGAGCTAACG	GTATTCAAGGCCATCA
AAAAAAAACGCTTGTGAGCTAACG	GTATTCAAGTAACGGA
AAAAAAAATAGCCCTGAGCTAACG	GTATTCAAGTGAACCT
AAAAAAAACCTTCAGGAGCTAACG	GTATTCAAGTTATCCT
AAAAAAAACATAAGTACTTCATGC	GTATTGTCAAATTCGT
AAAAAAAATCACCATACTTCATGC	GTATTGTCAAGACTCC
AAAAAAAAATACCGAACTTCATGC	GTATTGTCACCAGCAT
AAAAAAAACCGCCTAACTTCATGC	GTATTGTCACTAAGCC
AAAAAAAAAAGACAAACTTCATGC	GTATTGTCATCCTAGA
AAAAAAAACAATGAGCTGTGATTC	GTCAAACTCCGCTAGA
AAAAAAAACTTCCCGCTCACACAC	GTCAATATCGTCCTTA
AAAAAAAATACATACCTTTACTAG	GTCAGGCTCGAGCTAT
AAAAAAAACGTGATGACCTCATCA	GTCATCACAATGAATG
AAAAAAAAGAAACTCACCTCATCA	GTCATCACACCTCAGG
AAAAAAAACGCTAAGACCTCATCA	GTCATCACAGAATGAC
AAAAAAAATCTAACCACCTCATCA	GTCATCACAGGCTAAG
AAAAAAAATGGAGCGCTGTTACAC	GTCATCCTCCGTAAAC
AAAAAAAAAACTAAGCTGTTACAC	GTCATCCTCGGGATTT
AAAAAAAATGCTTCCTGTTCCCAC	GTCATGAGTAGCAGCT
AAAAAAAACAATACCTGTTCCCAC	GTCATGAGTCAGGAAG
AAAAAAAAAGAAACCTGTTCCCAC	GTCATGAGTCATTAGG
AAAAAAAAACCCTCAACAAGCTAC	GTCATGCCAGCATTAT
AAAAAAAAGTAACGCGAACACACG	GTCATTAAGCCTCTGT
AAAAAAAAGGCTAACGAACACACG	GTCATTAAGGTCCACA
AAAAAAAATCGCCTAGAACACACG	GTCATTAAGTGACCTG
AAAAAAAAGACTTACCTCAGTTAT	GTCCAAGTCCACCTGT
AAAAAAAATGATTTGCTCAGTTAT	GTCCAAGTCGTTAAGC
AAAAAAAAGCCATCATGCGAAACG	GTCCATTGTAGTAAGA
AAAAAAAAGGATTAGTGCGAAACG	GTCCATTGTATTCGTC
AAAAAAAATATTGCGTGCGAAACG	GTCCATTGTCACAGCG
AAAAAAAACTCACAATGCGAAACG	GTCCATTGTGTTCCCA
AAAAAAAATGTTGTTGAGCATAGC	GTCCGTAAGACAACAG
AAAAAAAACAGTTAGGAGCATAGC	GTCCGTAAGTAAGTGG
AAAAAAAAGTGAACCGAACATTAG	GTCCTAGAGCAAACCT
AAAAAAAACGTATTTGAACATTAG	GTCCTAGAGGGCTTAT
AAAAAAAAGTTGACGGAACATTAG	GTCCTAGAGTTCCTGC
AAAAAAAACTGCTAATGGAGACTA	GTCCTCAGTTACAAAC
AAAAAAAATCCTGAATGGAGACTA	GTCCTCAGTTATAGCG
AAAAAAAATCGGTATTGGAGACTA	GTCCTCAGTTTAGTCC
AAAAAAAAGCAACTAACCGCCCAT	GTCCTCCCAACTAGGG
AAAAAAAATGCTGTTACCGCCCAT	GTCCTCCCAAGGATTA
AAAAAAAATCAGTAAACCGCCCAT	GTCCTCCCAGCAAGAT
AAAAAAAATTCACCAACCGCCCAT	GTCCTCCCATTCCTCG
AAAAAAAAAGCAAGCCTAAAGCTA	GTCGCAATCACCATTT
AAAAAAAATTGGTAAACCCAAAGC	GTCGGTTCACTAAATC
AAAAAAAAAGCGTGCACCCAAAGC	GTCGGTTCAGAAACGT
AAAAAAAAAGGTTACACCCAAAGC	GTCGGTTCATCAATCG
AAAAAAAAATTGGTGACCCAAAGC	GTCGGTTCATTGTTGG
AAAAAAAAATTGCTCGAATGACCG	GTCTAACAGCCATCAG
AAAAAAAACTGGCAGGAATGACCG	GTCTAACAGCCTCTCG
AAAAAAAAATGGACCGAATGACCG	GTCTAACAGCGAGTAA
AAAAAAAAGAGAAACGAATGACCG	GTCTAACAGGAAACTG
AAAAAAAACATAGTGGAATGACCG	GTCTAACAGGGTGAAC
AAAAAAAATTGACTCACTGAGTGC	GTCTAATCAAAGGCCA
AAAAAAAAAAATGGAACTGAGTGC	GTCTAATCAACCCTCC
AAAAAAAATATGACAACTGAGTGC	GTCTAATCAATTATGC
AAAAAAAAACCCTCAACTGAGTGC	GTCTAATCAGCATTAT
AAAAAAAACCGGATAACTGAGTGC	GTCTAATCATGAATAG
AAAAAAAACTACCGCACGTGCCTT	GTCTAGCCATTTGCTC
AAAAAAAAAGAAACCTGCGTAACT	GTCTATCGTCATTAGG
AAAAAAAATTCGCGCACCGGTAAC	GTCTATGCAAACCTAT
AAAAAAAAGTTACCCACCGGTAAC	GTCTATGCACAGAAAC
AAAAAAAACCGTTGCACCGGTAAC	GTCTATGCACGGTACT
AAAAAAAATAAATGCACCGGTAAC	GTCTATGCAGGCCATT
AAAAAAAAGATCAGTACCGGTAAC	GTCTATGCATTAGCGC
AAAAAAAAGTCTTGACTGGAAACC	GTCTCACTCATGACCG
AAAAAAAAGGCTAGACTGTACGTT	GTCTTGCTCACTAAGC
AAAAAAAACTATCGGCTGTACGTT	GTCTTGCTCAGGGCCT
AAAAAAAACCAGAAACTGTACGTT	GTCTTGCTCCTAAGTA
AAAAAAAAGATGCAGCTGTACGTT	GTCTTGCTCTCCTCTT
AAAAAAAACCAATACTGCCAGCAC	GTCTTTAGTATGGTGC
AAAAAAAATCGTCCTTGCCAGCAC	GTCTTTAGTGTGAGGA
AAAAAAAAAGCTTGCTGCCAGCAC	GTCTTTAGTTTAGCTC
AAAAAAAAACACTTGCTAAGACTA	GTCTTTGTCAACAAGG
AAAAAAAAGACCAAGCTAAGACTA	GTCTTTGTCCATTACT
AAAAAAAAGCTCGACCTAAGACTA	GTCTTTGTCGCTAGTG
AAAAAAAAGAATATGCTAAGACTA	GTCTTTGTCGGGCCAT
AAAAAAAACCTGCTCCTAAGACTA	GTCTTTGTCTTGACCC
AAAAAAAACACCAAAGAGGTTGTG	GTGAACAAGTCAATTG
AAAAAAAAACATTAGGAGGTTGTG	GTGAACAAGTTCCCGT
AAAAAAAAAAGCACGCTCCTCATT	GTGAATCTCAGGAAGC
AAAAAAAAAGATTGACTCCTCATT	GTGAATCTCCTCACTA
AAAAAAAAATAGCTCCTCCTCATT	GTGAATCTCCTTAATC
AAAAAAAACTTGTAACTCCTCATT	GTGAATCTCTGCAAAC
AAAAAAAACAGATAATGTGGTTCA	GTGAGGAGTAGGTTAT
AAAAAAAAGCAGTAATGTGGTTCA	GTGAGGAGTATTGGAT
AAAAAAAACAGGAACTGATCAGGA	GTGATCAGTACTGATG
AAAAAAAAAGCATGATGATCAGGA	GTGATCAGTATTGGTG
AAAAAAAAGGTCCATTGATCAGGA	GTGATCAGTCGTAATG
AAAAAAAAAAGCTATGATAACCGA	GTGATGAAGGGTCCAC
AAAAAAAAGGCACTGACCCACATT	GTGCAAGCAAACTCAT
AAAAAAAACATAAGTACCCACATT	GTGCAAGCAAATTCGT
AAAAAAAATGAATTGACCCACATT	GTGCAAGCAATAATGG
AAAAAAAATCCGCACACCCACATT	GTGCAAGCAATCCTAG
AAAAAAAACTCAAGGACCCACATT	GTGCAAGCATTAGGTT
AAAAAAAAAAGTCGCGAATATCAG	GTGCATTAGCAGGTGG
AAAAAAAAAAATGTCGAATATCAG	GTGCATTAGCCTGTTC
AAAAAAAAGTGTAATGAATATCAG	GTGCATTAGGATTTGC
AAAAAAAATCTAGCGCTTAGTCAT	GTGCCTTTCGCGCTAA
AAAAAAAAGCGCATCCTTAGTCAT	GTGCCTTTCTAATCCT
AAAAAAAAATTAAGGCTACTGAGG	GTGCGGTTCACCGGTA
AAAAAAAATAACTTCGAGGAACAA	GTGCTCAAGCCTGGTA
AAAAAAAACACATACTGACCTGCA	GTGCTCCGTGCAACTA
AAAAAAAATGCTCTCTGACCTGCA	GTGCTCCGTTGCTTCG
AAAAAAAAGCAAATACTAACTAAG	GTGCTGATCTCGACCT
AAAAAAAATCCACAATGAGACTCC	GTGCTGGGTTTGCTGT
AAAAAAAATTGAGGACTCTAACTA	GTGCTTCTCAAACACC
AAAAAAAAGGCACTGACGAGCAAG	GTGGACACAAACTCAT
AAAAAAAATAAACGTACGAGCAAG	GTGGACACAGCAATAA
AAAAAAAACCTAAGGACGAGCAAG	GTGGACACATTGTCCT
AAAAAAAAGTAAGCTACGGTTCAA	GTGGATGCAACCTAAT
AAAAAAAACCACTATACAGGAACG	GTGGCTTCAGTCTAGC
AAAAAAAACCGGATAACAGGAACG	GTGGCTTCATGAATAG
AAAAAAAAAGCAAGCCTCACTTGG	GTGTAACTCACCATTT
AAAAAAAAAGGTGCACTCACTTGG	GTGTAACTCAGGTTTA
AAAAAAAAGCTAACGGACGAATAC	GTGTCCAAGCTTAACA
AAAAAAAACTATTGCACGTAGCGC	GTGTGAGCAATATGGA
AAAAAAAATACTTGCACGTAGCGC	GTGTGAGCATAATGTC
AAAAAAAAACCTCGCGAACAAGTT	GTGTGTTAGCACTAAC
AAAAAAAAAGTGTGCGAACAAGTT	GTGTGTTAGCTTACTT
AAAAAAAAAACGATTGAACAAGTT	GTGTGTTAGGTTAGAG
AAAAAAAAACCATACCTTAATTCG	GTGTTCCTCATGGCCA
AAAAAAAACGCAACCTGCCGCAAC	GTTAAACGTAGCTGGT
AAAAAAAATGTTGCATGCCGCAAC	GTTAAACGTCAAAGGG
AAAAAAAAACACCGTTGCCGCAAC	GTTAAACGTTATTGCC
AAAAAAAATAGAGATTGCCGCAAC	GTTAAACGTTTGGCTT
AAAAAAAAACCCGCTGACTGAGCG	GTTAACCAGCAAGGTA
AAAAAAAAAGTCAATGACTGAGCG	GTTAACCAGCGCTAAT
AAAAAAAATTAGCCATGAAGGATC	GTTAACGGTGCATCGG
AAAAAAAAAAGCATGTGAAGGATC	GTTAACGGTTTGGCGG
AAAAAAAACATTAGTCTACTAGCT	GTTAAGCTCAATGACC
AAAAAAAAAGATTGACTACTAGCT	GTTAAGCTCCTCACTA
AAAAAAAAATAGATGCTACTAGCT	GTTAAGCTCTACCTGC
AAAAAAAATCCCGGATGCGTGATT	GTTAAGTGTAGTTAAC
AAAAAAAAACAATAGCTGAGCAAC	GTTAATGTCTAAATCG
AAAAAAAAATACAGGTGCCTCAAA	GTTACAGGTCAATGTG
AAAAAAAAGGTATAGTGCCTCAAA	GTTACAGGTGTTGTAG
AAAAAAAATGTTGCATGTCACGAT	GTTACCTGTCAAAGGG
AAAAAAAAAAGGTCATGTCACGAT	GTTACCTGTCATAAGT
AAAAAAAACTACTGATGTCACGAT	GTTACCTGTTACTTGC
AAAAAAAAGTAGCTAACATCAAGC	GTTACGCCAAGGTAAC
AAAAAAAAAACCCTCACATCAAGC	GTTACGCCAATCTCTC
AAAAAAAACTTCGTAACATCAAGC	GTTACGCCACAACAAA
AAAAAAAAGCGCACAACATCAAGC	GTTACGCCATCAGCAC
AAAAAAAAGCCAGCAACATCAAGC	GTTACGCCATCGCTTT
AAAAAAAACACAGGCGACACAAAC	GTTACTAAGGACTTAC
AAAAAAAATCAGGTAGACACAAAC	GTTACTAAGTTAGTTG
AAAAAAAACTCCTACTGAGTTAGG	GTTACTCGTTTGACCT
AAAAAAAAGCATGAGCTCATGAAG	GTTAGACTCCACCCTG
AAAAAAAATGACTTACTCATGAAG	GTTAGACTCGAGGTGG
AAAAAAAACGCTAGCTGGTTTACA	GTTAGGCGTTGGTTAG
AAAAAAAATTTAAGCCTAGTTGGG	GTTCACCTCTTGAGGT
AAAAAAAAAAGGAAGCTAGTTGGG	GTTCACCTCTTGCAGG
AAAAAAAAAATCCACCTAACCTGT	GTTCATTTCCCGAAGC
AAAAAAAATTAGGTTCTAACCTGT	GTTCATTTCCTTCGTA
AAAAAAAAGCAAGTGCTAACCTGT	GTTCATTTCGTTTCGC
AAAAAAAACGTCAATTGTGCAGCC	GTTCCCAGTAGCTAGC
AAAAAAAAAAGCCCTTGTGCAGCC	GTTCCCAGTAGTTGGC
AAAAAAAAAGTCATTTGGCTATAT	GTTCCTGGTATGTGGC
AAAAAAAATATTGGCTGGCTATAT	GTTCCTGGTCACAGAC
AAAAAAAAGCTCCCTTGGCTATAT	GTTCCTGGTCTCACTG
AAAAAAAAGAGCTGGTGGCTATAT	GTTCCTGGTGCATTTC
AAAAAAAATAGAGATTGGCTATAT	GTTCCTGGTTTGGCTT
AAAAAAAAGCCAGCAACTCACGGA	GTTCCTTCATCGCTTT
AAAAAAAACGTGAAACTAATCACC	GTTCGCTTCAAGGACA
AAAAAAAAAGGTTAACTAATCACC	GTTCGCTTCTGTAAGC
AAAAAAAAATTAGCCCTCCATCAG	GTTCTCATCTCAATAG
AAAAAAAAGGCATGGTGCACAGCC	GTTCTTAGTCATAGAT
AAAAAAAAACGCTTACTTATTACG	GTTCTTGTCATGAAGG
AAAAAAAAATGACAACTTATTACG	GTTCTTGTCATGCCTC
AAAAAAAAAGAGAAGCTTATTACG	GTTCTTGTCGTCAAGT
AAAAAAAACTTAATGCTTATTACG	GTTCTTGTCTTAGGGT
AAAAAAAAGCTTTGTGACTAGTAG	GTTGCATAGTCATGCG
AAAAAAAAGCTCCCTTGGTGAAGT	GTTGCCCGTCTCACTG
AAAAAAAAAACGATTGAGGGACTT	GTTGCTGAGGTTAGAG
AAAAAAAAGACCTAGGAGGGACTT	GTTGCTGAGTAAGTCC
AAAAAAAATTGGGTTTGAATCACT	GTTGTGAGTAACAGGG
AAAAAAAAGATGACATGAATCACT	GTTGTGAGTAATAACC
AAAAAAAAACGTATTTGAATCACT	GTTGTGAGTACCGTTT
AAAAAAAAAGAATGAACAAACGCT	GTTGTTGCAGGCTGTT
AAAAAAAAGGTACTAACAAACGCT	GTTGTTGCAGTCTAAT
AAAAAAAATCGAAGCACAAACGCT	GTTGTTGCATTGTGGC
AAAAAAAATCACCATACCTGGTTT	GTTTAACCAAGACTCC
AAAAAAAATGGTGTGACCTGGTTT	GTTTAACCACAAAGGT
AAAAAAAACCAAGGTACCTGGTTT	GTTTAACCACAGCCAT
AAAAAAAAGCGCACAACCTGGTTT	GTTTAACCATCAGCAC
AAAAAAAAAACTGAGTGTTGTTGG	GTTTACCGTTGCTGGG
AAAAAAAAGACACCTTGTTGTTGG	GTTTACCGTTTGGGCG
AAAAAAAACCAACAAGACTTAGCC	GTTTAGCAGCCACATG
AAAAAAAATGCGCTTGACTTAGCC	GTTTAGCAGTTTAACG
AAAAAAAACAACAAGCTTGAGGAT	GTTTATCTCCCTTGCG
AAAAAAAAAGAAAGGCTTGAGGAT	GTTTATCTCTCACTCA
AAAAAAAATGGTCCACTTGAGGAT	GTTTATCTCTTAGTGA
AAAAAAAAAAGAACAACGCAAGGA	GTTTCAGCAAACATAG
AAAAAAAACTCATTGACGCAAGGA	GTTTCAGCAAATACCT
AAAAAAAAGTCTTTAACGCAAGGA	GTTTCAGCACAATGTT
AAAAAAAATTTGTGCACGCAAGGA	GTTTCAGCATAGGCGA
AAAAAAAACAGGATCACGCAAGGA	GTTTCAGCATCTTGAG
AAAAAAAACCATTACACGCAAGGA	GTTTCAGCATTGTGAT
AAAAAAAAGAAGCGAACTTACCGT	GTTTCCTCACGGTTTA
AAAAAAAATTACTGCACTTACCGT	GTTTCCTCAGTATGTT
AAAAAAAATATGATGACTTACCGT	GTTTCCTCATAGCTGC
AAAAAAAACCCTGTGACTTACCGT	GTTTCCTCATGAGTTT
AAAAAAAACTAACCTACTTACCGT	GTTTCCTCATGATTGT
AAAAAAAAAGCTATTTGAATCGCC	GTTTCTAGTGCTCACC
AAAAAAAACACAGGATGAATCGCC	GTTTCTAGTTATGTGG
AAAAAAAAAAGAACCTGGAGCAGC	GTTTGCTGTAATGGAA
AAAAAAAAACGGATCGAAGCTAAT	GTTTGTAAGCCACAAT
AAAAAAAACCTTACGGAAGCTAAT	GTTTGTAAGGAGCATA
AAAAAAAAGAAAGCCCTCTTGAAT	GTTTGTTTCAGGATGA
AAAAAAAAGCGGTAACTCTTGAAT	GTTTGTTTCATGGTTA
AAAAAAAACAGTTTACTCTTGAAT	GTTTGTTTCCGCACAA
AAAAAAAATTTCAAGCTCTTGAAT	GTTTGTTTCCTAATTC
AAAAAAAACGGAGCACTCTTGAAT	GTTTGTTTCCTAGTAA
AAAAAAAAAGTAATGCTCTTGAAT	GTTTGTTTCCTTCAAT
AAAAAAAAGTGATGGCTCTTGAAT	GTTTGTTTCTTGCTAT
AAAAAAAAACTTAGGACGCTTGCT	TAAACAGCATCATGGC
AAAAAAAACACCATTACGCTTGCT	TAAACAGCATGCATAT
AAAAAAAAAGCTTGTCTTAGTGTT	TAAAGCCTCATTCATC
AAAAAAAAGTCCATCACGCAACAT	TAACAAGCATTCCTGT
AAAAAAAAGCATATTTGTTCCTGC	TAACCAGGTAAACAAG
AAAAAAAAACGCGTTTGTTCCTGC	TAACCAGGTGAGAAAC
AAAAAAAAAACTGAGTGTTCCTGC	TAACCAGGTTGCTGGG
AAAAAAAAAGGAGGATGTTCCTGC	TAACCAGGTTGTTGGA
AAAAAAAATATATCGCTAACCGTT	TAACCGGTCAGTATTG
AAAAAAAATTACCGGCTAACCGTT	TAACCGGTCCCTCGCA
AAAAAAAACCTAAGCCTAACCGTT	TAACCGGTCTAACCAA
AAAAAAAATCCCGGATGTGTGGTT	TAAGCCAGTAGTTAAC
AAAAAAAAGCTGTCATGTGTGGTT	TAAGCCAGTCAAGTAT
AAAAAAAACTCAGTATGTGTGGTT	TAAGCCAGTTAGGCGT
AAAAAAAACGATCCGTGTGTGGTT	TAAGCCAGTTTAAAGC
AAAAAAAAACCCGCTGAATTAAGC	TAAGCCTAGCAAGGTA
AAAAAAAATATTCGTGAATTAAGC	TAAGCCTAGCTCCCTG
AAAAAAAAGATTCCTGAATTAAGC	TAAGCCTAGGACCTCA
AAAAAAAATAAATCCCTGCAGGTA	TAAGCTATCTTGTCTG
AAAAAAAACCCAAATTGGTTCTGG	TAAGCTGGTAAGGTCC
AAAAAAAATCCAACATGGTTCTGG	TAAGCTGGTCAAAGAA
AAAAAAAAACCATTATGGTTCTGG	TAAGCTGGTTTATCTG
AAAAAAAAGCGCTAGACGTTTCGC	TAAGGACCAAGGTACG
AAAAAAAAGGTTGCGACGTTTCGC	TAAGGACCACCCACAG
AAAAAAAAGCTGGTGACGTTTCGC	TAAGGACCATGCTATG
AAAAAAAAACTAAAGCTAACCTAC	TAAGGCTTCATTTGCT
AAAAAAAAGTTTAGCCTAACCTAC	TAAGGCTTCCATCAGG
AAAAAAAATGGTCCACTAACCTAC	TAAGGCTTCTTAGTGA
AAAAAAAAGACTCAAACGGTTAAC	TAAGTAGCAATTTGGT
AAAAAAAACAAACTAACGGTTAAC	TAAGTAGCATGTCAGC
AAAAAAAATACGCCACTTAAGCCC	TAAGTGCTCCCTGGAA
AAAAAAAAACTGACAACTATGTGA	TAATCACCACAGGAAT
AAAAAAAAGGTACGCACTATGTGA	TAATCACCACTTCACT
AAAAAAAAAGTCCTCACCATTAAG	TAATCCGCAAGTGAAC
AAAAAAAATGCGCCTACCATTAAG	TAATCCGCAATATACC
AAAAAAAAACACCAAACCATTAAG	TAATCCGCAGGTTATT
AAAAAAAATATGTCCACCATTAAG	TAATCCGCATAAGTTC
AAAAAAAAGAGAAGCACCATTAAG	TAATCCGCATGTGGGA
AAAAAAAAAAGTTAGCTTGTCCAG	TAATGCATCAAACCGT
AAAAAAAACTTAGGCCTTGTCCAG	TAATGCATCAATCTCT
AAAAAAAAGGTTATCCTTGTCCAG	TAATGCATCGTTATAG
AAAAAAAAATAGATGCTTGTCCAG	TAATGCATCTACCTGC
AAAAAAAAGACAAGCCTTGTCCAG	TAATGCATCTCAATGA
AAAAAAAATGGTGTGACGGTACGC	TAATGGACACAAAGGT
AAAAAAAATAAACGTACGGTACGC	TAATGGACAGCAATAA
AAAAAAAAGGTGTTAACGGTACGC	TAATGGACAGGTTAAA
AAAAAAAAGCTTCTTTGATCACAT	TAATGGTGTGAGACTC
AAAAAAAAGAACTGATGATCACAT	TAATGGTGTGATGATT
AAAAAAAATGAATTGACCTTACCA	TAATTGCCAATAATGG
AAAAAAAATCCGGAAACCTTACCA	TAATTGCCACATAACT
AAAAAAAAGGGAACAACCTTACCA	TAATTGCCACTCGCTC
AAAAAAAAACCCTCAACCTTACCA	TAATTGCCAGCATTAT
AAAAAAAAAGAATGAACCTTACCA	TAATTGCCAGGCTGTT
AAAAAAAAAGAATCACTGATGGAC	TACAACATCCTCCCTC
AAAAAAAAACAAGCGCTGGAAGCT	TACAAGCTCAATAGCC
AAAAAAAATTTCAAGCTGGAAGCT	TACAAGCTCCTAATTC
AAAAAAAAACACTTGCTATTACGC	TACAATGTCAACAAGG
AAAAAAAAGTTCACTGAGGTTAGC	TACAGCTAGCATGAAG
AAAAAAAATGGCTAAGAGGTTAGC	TACAGCTAGCTCCTAC
AAAAAAAATCTATGTGAGGTTAGC	TACAGCTAGGGTGAGT
AAAAAAAACACCAGGGAGGTTAGC	TACAGCTAGTAACTCA
AAAAAAAATCATCATGAGGTTAGC	TACAGCTAGTCATTGA
AAAAAAAAACCGGCTCTGAGGAGG	TACAGGTTCGCTTGCT
AAAAAAAAGCGATAGCTGAGGAGG	TACAGGTTCTAATTGG
AAAAAAAATACGTTACTAAAGCGC	TACCAAATCAAACTCA
AAAAAAAACGACAGGCTAAAGCGC	TACCAAATCAAGCGCC
AAAAAAAAGGCATTTCTGATGAAT	TACCAGGTCATTAGTG
AAAAAAAATGTCAATCTGATGAAT	TACCAGGTCCCTCAAC
AAAAAAAACTATATGCTGATGAAT	TACCAGGTCCCTGATC
AAAAAAAATTACTCCCTGATGAAT	TACCAGGTCTAGCTTT
AAAAAAAACATAAGTACCACAATA	TACCCGGCAAATTCGT
AAAAAAAACCGTTTAACCACAATA	TACCCGGCACTGACTA
AAAAAAAAGTGCGAGTGAGGAACT	TACCGAAGTATTGAGT
AAAAAAAACCAGGCTTGAGGAACT	TACCGAAGTCATGCAA
AAAAAAAACGCTACGTGAGGAACT	TACCGAAGTGTGCAAC
AAAAAAAACTGATTTGAACCTAGG	TACCGCAAGCTTTGTT
AAAAAAAAGGATTGCGAACCTAGG	TACCGCAAGGTGTTAC
AAAAAAAACTCGAGCTGCACACCG	TACCGTTGTAACTACG
AAAAAAAAGGCATGACTTGACTAT	TACCTCATCCAGGTTG
AAAAAAAAGTTTAGCCTTGACTAT	TACCTCATCCATCAGG
AAAAAAAATGCTGTGCTTGACTAT	TACCTCATCCTGATTT
AAAAAAAACAAGTCCCTTGACTAT	TACCTCATCGTTACTT
AAAAAAAAGGCTAGACTGTCCATA	TACCTGCTCACTAAGC
AAAAAAAAAAACATGCTGTCCATA	TACCTGCTCCAATAGC
AAAAAAAAAGTCATTTGCTAGCCG	TACCTTAGTATGTGGC
AAAAAAAAGGGTAGCTGCTAGCCG	TACCTTAGTCCTAAGA
AAAAAAAACAGCATTTGCTAGCCG	TACCTTAGTGAACAAA
AAAAAAAACTCACAATGCTAGCCG	TACCTTAGTGTTCCCA
AAAAAAAATGGCTATTGCTAGCCG	TACCTTAGTTCACTGT
AAAAAAAACATGTCATGCTAGCCG	TACCTTAGTTGTTGCT
AAAAAAAATGCAGGATGCTAGCCG	TACCTTAGTTTCCTCC
AAAAAAAACGCGAGTGAAATCGCG	TACCTTTAGAAAGGAA
AAAAAAAAGATCCAGGAAATCGCG	TACCTTTAGCCGCTTT
AAAAAAAATGAGCGCGAAATCGCG	TACCTTTAGCTAATCA
AAAAAAAAGTTACCTGAAATCGCG	TACCTTTAGGATTGCT
AAAAAAAAGTACTGGGAAATCGCG	TACCTTTAGTCTGGGC
AAAAAAAAGCACCTTACATTACGG	TACGCACCAATTGACT
AAAAAAAATAAGGTTACATTACGG	TACGCACCACGAATCC
AAAAAAAAAGAAATGACATTACGG	TACGCACCACTTAGGC
AAAAAAAAACCCTCAACATTACGG	TACGCACCAGCATTAT
AAAAAAAATGCTTCCTGCGCATCG	TACGCTTGTAGCAGCT
AAAAAAAATTAAGGATGCGCATCG	TACGCTTGTTGGATCA
AAAAAAAATCGTGCTGAAGCGAGG	TACGGTTAGTTGCCTC
AAAAAAAAGTTTCCAGACTAAGGT	TACGTACAGCTGGCTA
AAAAAAAATATTGCTGACTAAGGT	TACGTACAGGAACACA
AAAAAAAACATAACGGACTAAGGT	TACGTACAGGGACCTC
AAAAAAAATAAACCGGATTAGCAG	TACGTTAAGCAGGCCT
AAAAAAAAGAAGTTTGATTAGCAG	TACGTTAAGCATGTTA
AAAAAAAACCTTCAGGATTAGCAG	TACGTTAAGTTATCCT
AAAAAAAACGCCTCTCTCTGTTGG	TACTAAGTCAGGAACA
AAAAAAAATGGTTATCTCTGTTGG	TACTAAGTCCTAAATG
AAAAAAAATGCATCGCTCTGTTGG	TACTAAGTCGAGGAAC
AAAAAAAACATCCTGGAATTAGGT	TACTGACAGGAACGCG
AAAAAAAACCTTACGGAATTAGGT	TACTGACAGGAGCATA
AAAAAAAAGACCTAGGAATTAGGT	TACTGACAGTAAGTCC
AAAAAAAAAAGAACCTGTTAGCGT	TACTGAGGTAATGGAA
AAAAAAAAGCTGGTTTGTTAGCGT	TACTGAGGTACTGAAT
AAAAAAAACAATCCATGTTAGCGT	TACTGAGGTCCAAATG
AAAAAAAAGTACCGTTGTTAGCGT	TACTGAGGTTAGCTGA
AAAAAAAACTCAGTATGTTAGCGT	TACTGAGGTTAGGCGT
AAAAAAAAAGACCATACGCGTTTC	TACTGGCCAGCTAACC
AAAAAAAAAGCTTGAACGCGTTTC	TACTGGCCAGCTCATA
AAAAAAAATTAAAGCACGCGTTTC	TACTGGCCATAATCCG
AAAAAAAATTCACTGACGCGTTTC	TACTGGCCATCCTGAA
AAAAAAAACAGGAATCTCACCCTC	TACTTCGTCTCTAGCC
AAAAAAAATTTAAGCCTCACCCTC	TACTTCGTCTTGAGGT
AAAAAAAAAGAGCTGCTCACATTA	TACTTGTTCAAGTGAG
AAAAAAAAACCAATCCTCACATTA	TACTTGTTCGCTTCTA
AAAAAAAAAGCAAACTGATCTTAG	TAGACCAGTAATCGGC
AAAAAAAAAGCTACCTGATCTTAG	TAGACCAGTGGTTCCC
AAAAAAAACTCCTACTGATCTTAG	TAGACCAGTTTGACCT
AAAAAAAAGTCGCTATGAGAAGGG	TAGAGCCGTAAGCTCA
AAAAAAAAGATTGCAACAAGGCCC	TAGCAGGCAATTAAGG
AAAAAAAACATAATCCTATTGCAC	TAGCATATCACGAATC
AAAAAAAATTGGCCACTATTGCAC	TAGCATATCCGGTTGA
AAAAAAAATAAATCCCTATTGCAC	TAGCATATCTTGTCTG
AAAAAAAACATAGCCCTATACCTG	TAGCCTCTCATTGTCT
AAAAAAAAAGCACCTTGAGGAGGA	TAGCCTTGTGCTTAGA
AAAAAAAACTAATGCTGAGGAGGA	TAGCCTTGTGGCTTCC
AAAAAAAAGTTCCTTTGAGGAGGA	TAGCCTTGTGGTTATG
AAAAAAAACGTGCACTGGATCCGT	TAGCGCGGTTAATCGG
AAAAAAAAGGTGTGACTAACTTCG	TAGCGGCTCCAAGTGT
AAAAAAAAGATTGCTCTCATGCGT	TAGCTAATCCTTGCAC
AAAAAAAACAGTTATCTCATGCGT	TAGCTAATCTAAGGAG
AAAAAAAATGTCCTTCTCATGCGT	TAGCTAATCTACTAAG
AAAAAAAAAGATGCATGACAGTGA	TAGCTAGGTTCGGGAT
AAAAAAAATGGCTAAGAAAGGATG	TAGCTTAAGCTCCTAC
AAAAAAAACGTAGTAGAAAGGATG	TAGCTTAAGGATAAAC
AAAAAAAAGCTTAAAGAAAGGATG	TAGCTTAAGGCTACAT
AAAAAAAAGAATATCGAAAGGATG	TAGCTTAAGTTAGCTA
AAAAAAAACTGTTACACTGGCTAG	TAGCTTGCAACAGGTG
AAAAAAAAGTGGCCAACTGGCTAG	TAGCTTGCAAGTTATC
AAAAAAAATATGTCCACTGGCTAG	TAGCTTGCATAAGTTC
AAAAAAAATGCTGTTACTGACAAT	TAGGAACCAAGGATTA
AAAAAAAATCCTCCTACTGACAAT	TAGGAACCATAATCAC
AAAAAAAAGTCCGGAACTGACAAT	TAGGAACCATGGCCTG
AAAAAAAAGACATCCTGCAATGAA	TAGGAGGGTCTAACAG
AAAAAAAAAGTCACCTGCAATGAA	TAGGAGGGTTAGGTGC
AAAAAAAAGTGATGATGCTTAGGT	TAGGCTAGTAACCACA
AAAAAAAAGCAGTAATGCTTAGGT	TAGGCTAGTATTGGAT
AAAAAAAAGGTTCACTGCTTAGGT	TAGGCTAGTCTATCGT
AAAAAAAACAGCGCTTGCTTAGGT	TAGGCTAGTGTAATAC
AAAAAAAATCCAGATTGCTTAGGT	TAGGCTAGTTAAGCCA
AAAAAAAACCTAGCGTGCTTAGGT	TAGGCTAGTTAGGACC
AAAAAAAATCATGGAGAAGTGATT	TAGGCTTAGACCATAC
AAAAAAAACGCTATGCTTCATGAT	TAGGGTTTCCACCTTA
AAAAAAAAATAGATGCTTCATGAT	TAGGGTTTCTACCTGC
AAAAAAAATTAACACCTTCATGAT	TAGGGTTTCTTTAGGA
AAAAAAAACCAATACTGCACTTAG	TAGGTGCGTATGGTGC
AAAAAAAATTGGTCATGCACTTAG	TAGGTGCGTTGGTTGA
AAAAAAAATGTTGGCCTACCTATG	TAGGTTATCACTAGGT
AAAAAAAAGTCCTAACTACCTATG	TAGGTTATCCCATAAA
AAAAAAAACTGCTCCCTACCTATG	TAGGTTATCTCACTAT
AAAAAAAACAAACAATGAGGTGGC	TAGTAACGTGTCCAAA
AAAAAAAATACAACAACCAGGTCA	TAGTAAGCAACTAGCC
AAAAAAAAGCCACTTACCAGGTCA	TAGTAAGCACCCTCAC
AAAAAAAAATCCGCTACCAGGTCA	TAGTAAGCACCTACTT
AAAAAAAATCCCATAACCAGGTCA	TAGTAAGCAGAAATGC
AAAAAAAAGCTTATTACCAGGTCA	TAGTAAGCATAAAGCA
AAAAAAAAGCGCACAACCAGGTCA	TAGTAAGCATCAGCAC
AAAAAAAAGTCCGGAACCAGGTCA	TAGTAAGCATGGCCTG
AAAAAAAAATTAGTGGATTGAGCA	TAGTAGGAGGACCTTG
AAAAAAAACTGCTGTGATTGAGCA	TAGTAGGAGGGATGAC
AAAAAAAACATGTTTGATTGAGCA	TAGTAGGAGTCCTGAG
AAAAAAAATCCAATACTGTGATAA	TAGTCAATCTAATCAG
AAAAAAAACACCCTCCTGTGATAA	TAGTCAATCTAGCTAA
AAAAAAAACGGACAATGCCGGTGT	TAGTGGCGTTAAGGTT
AAAAAAAACGTTATGTGGCTTCCC	TAGTGTGGTAATCGTG
AAAAAAAATCCTCCATGGCTTCCC	TAGTGTGGTTGTCCAT
AAAAAAAATTGCATGTGGCTTCCC	TAGTGTGGTTTGGTTC
AAAAAAAACCGGTTCACGTTGTCC	TAGTTGTCAGTAAGTA
AAAAAAAAGCAACTAACCGAATTA	TATAACCCAACTAGGG
AAAAAAAACGTAAATACCGAATTA	TATAACCCAGCTAATT
AAAAAAAAACCGAATACCGAATTA	TATAACCCAGGACCAA
AAAAAAAATAGTAACACCGAATTA	TATAACCCAGTTTGTG
AAAAAAAACTAACCTACCGAATTA	TATAACCCATGATTGT
AAAAAAAAACCAAATGATCCTGCA	TATAGCCAGCTATTAG
AAAAAAAAAAGGGAGTGTGCAATC	TATAGGTGTAATGGCC
AAAAAAAACGCTACGTGTGCAATC	TATAGGTGTGTGCAAC
AAAAAAAAAGAGCTGCTCCTACTT	TATATCCTCAAGTGAG
AAAAAAAATAAGGTGCTCCTACTT	TATATCCTCCTCACAC
AAAAAAAACAACCTGCTCCTACTT	TATATCCTCGCGACAC
AAAAAAAATGATTTGCTCCTACTT	TATATCCTCGTTAAGC
AAAAAAAAGACGAGGGATGATGAC	TATCACAAGCATGTCG
AAAAAAAAGATTAGTGATGATGAC	TATCACAAGCTTATGA
AAAAAAAATAGGCATGATGATGAC	TATCACAAGGTGCGGA
AAAAAAAACCTTCAGGATGATGAC	TATCACAAGTTATCCT
AAAAAAAATTGACTCACCTTCCTC	TATCACGCAAAGGCCA
AAAAAAAAACCCGGAACCTTCCTC	TATCACGCAACCCTAA
AAAAAAAATCAAACAACCTTCCTC	TATCACGCAGGATGGC
AAAAAAAATACTTGCACCTTCCTC	TATCACGCATAATGTC
AAAAAAAACATGGTGACCTTCCTC	TATCACGCATACCCGG
AAAAAAAAACACCAAACCGAAGTC	TATCCAGCAGGTTATT
AAAAAAAACATGGTGACCGAAGTC	TATCCAGCATACCCGG
AAAAAAAACACCATTACCGAAGTC	TATCCAGCATGCATAT
AAAAAAAAAGCTAATGACATAGTG	TATCCGGAGTGGACAA
AAAAAAAAGAAGAAATGAATCGTT	TATCGAGGTACGTTTC
AAAAAAAAAGTCATTTGAATCGTT	TATCGAGGTATGTGGC
AAAAAAAAGAAACTCACCTTTAGC	TATCGCACACCTCAGG
AAAAAAAAATTGGTGACCTTTAGC	TATCGCACATTGTTGG
AAAAAAAAGCTTCATGATAAGCTG	TATCGCGAGTTATTCC
AAAAAAAATACAACAACAGTAAGA	TATGAAGCAACTAGCC
AAAAAAAAACACTTGCTTTGTAAC	TATGACATCAACAAGG
AAAAAAAACATAGCCCTTTGTAAC	TATGACATCATTGTCT
AAAAAAAACTTTAAGCTTTGTAAC	TATGACATCCAATTAG
AAAAAAAATGAGTGACTTTGTAAC	TATGACATCCTGGCTT
AAAAAAAATCAATTGCTTTGTAAC	TATGACATCTCCATAT
AAAAAAAATGAACCGACCTTTGAC	TATGACTCACATACTG
AAAAAAAAACCGAATACCTTTGAC	TATGACTCAGGACCAA
AAAAAAAAGAAAGGCACCTTTGAC	TATGACTCATCCAGGT
AAAAAAAAGGCACTGACCGTAAAT	TATGCATCAAACTCAT
AAAAAAAATATGACAACCGTAAAT	TATGCATCAATTATGC
AAAAAAAACCGCCTAACCGTAAAT	TATGCATCACTAAGCC
AAAAAAAATGGCATGACCGTAAAT	TATGCATCATAAGTCT
AAAAAAAAAAAGTGAACCGTAAAT	TATGCATCATTTAAGC
AAAAAAAAGAGCGGTTGAATCCAT	TATGGATGTTAAGCGC
AAAAAAAAAGGGATTTGAATCCAT	TATGGATGTTGTAAAC
AAAAAAAACAGCGATACTTCCTTT	TATGGCCCACCTAAGC
AAAAAAAAGGTGTTAACTTCCTTT	TATGGCCCAGGTTAAA
AAAAAAAATTACTGCACTTCCTTT	TATGGCCCAGTATGTT
AAAAAAAAAATCGTGACTTCCTTT	TATGGCCCAGTTTCTC
AAAAAAAAAGTCAGTACTTCCTTT	TATGGCCCATGAAATG
AAAAAAAATGCAACAGATTGAGTG	TATGGTCAGAGGCTAA
AAAAAAAACCATTATGATTGAGTG	TATGGTCAGATAGACG
AAAAAAAATCCTTAAGATTGAGTG	TATGGTCAGCACAGAA
AAAAAAAATCGATTTGATTGAGTG	TATGGTCAGCGAAGTA
AAAAAAAAACAAGCGCTATCGCAT	TATGTGATCAATAGCC
AAAAAAAATCTAAGTCTATCGCAT	TATGTGATCACTCGCT
AAAAAAAAAGAACCGCTATCGCAT	TATGTGATCTCACACC
AAAAAAAACGTGATGACCAAACAT	TATTAGCCAATGAATG
AAAAAAAAGCGTGACACCAAACAT	TATTAGCCACTAAGAA
AAAAAAAAAGCTCAAACCAAACAT	TATTAGCCATCGCTCC
AAAAAAAACATAATGACCAAACAT	TATTAGCCATGGTTAT
AAAAAAAAGGTTAACACCAAACAT	TATTAGCCATTATGCG
AAAAAAAAATGATGACTTCCAGCA	TATTAGGTCAGGTCCA
AAAAAAAAGCTCAATCTTCCAGCA	TATTAGGTCTTAGTCT
AAAAAAAAAAGAACAACAAAGGTA	TATTGACCAAACATAG
AAAAAAAATTGACTCACAAAGGTA	TATTGACCAAAGGCCA
AAAAAAAACTTAGAAACAAAGGTA	TATTGACCAGCCTGCA
AAAAAAAATAGGTTTCTGGATCCC	TATTTGCTCGCTCACT
AAAAAAAACGACAAACTGGATCCC	TATTTGCTCTTTAAGG
AAAAAAAACCATTATGAAGCCTCC	TATTTGGAGATAGACG
AAAAAAAACAATTGGGAAGCCTCC	TATTTGGAGCATGCAT
AAAAAAAACCATAAGGAAGCCTCC	TATTTGGAGTTGGCCA
AAAAAAAACTTAGGCCTCATAGCC	TCAACAATCAATCTCT
AAAAAAAATTAGGTTCTCATAGCC	TCAACAATCCTTCGTA
AAAAAAAAACCGGCTCTCATAGCC	TCAACAATCGCTTGCT
AAAAAAAAGACAAGCCTCATAGCC	TCAACAATCTCAATGA
AAAAAAAACGTCCCTCTCATAGCC	TCAACAATCTTACTCG
AAAAAAAACAAGGCTACCTCCTAA	TCAAGAACAGCATGGA
AAAAAAAACCCTGTGACCTCCTAA	TCAAGAACATGAGTTT
AAAAAAAAGAAAGCCCTTGTGACC	TCAAGACTCAGGATGA
AAAAAAAAGATTGCTCTTGTGACC	TCAAGACTCCTTGCAC
AAAAAAAAAACCCTTGAGCATATA	TCAAGCTAGCGATAGA
AAAAAAAACGTTAAGGAGCATATA	TCAAGCTAGTCATCCC
AAAAAAAAATATTGGGATTCCGCA	TCAAGGAAGCTTTGGG
AAAAAAAACCGCTTAGATTCCGCA	TCAAGGAAGTAAAGGT
AAAAAAAATCATCATGATTCCGCA	TCAAGGAAGTCATTGA
AAAAAAAAGCCAGCTCTACGGGTA	TCAAGGTTCCAGGTCA
AAAAAAAAGTTTAGCCTACGGGTA	TCAAGGTTCCATCAGG
AAAAAAAACCAATATCTACGGGTA	TCAAGGTTCCTAATGA
AAAAAAAATTACAACCTACGGGTA	TCAAGGTTCCTGGTCT
AAAAAAAAACGGTTTCTACGGGTA	TCAAGGTTCGTTAACA
AAAAAAAACTATCGGCTCAAAGGT	TCAAGTATCAGGGCCT
AAAAAAAACAATGAGCTCAAAGGT	TCAAGTATCCGCTAGA
AAAAAAAACTAGTAAACCGGCTAA	TCAATCGCAGTAAAGC
AAAAAAAAGAGTTGCGAGTGATGC	TCACATAAGATGGAGC
AAAAAAAAAAACCCGGAGTGATGC	TCACATAAGGCGTAAA
AAAAAAAATCTCAATGAGTGATGC	TCACATAAGGTCATTA
AAAAAAAATGAATTGACTGGCATG	TCACCGGCAATAATGG
AAAAAAAAGGTTAATGAAGCCAGT	TCACCTCAGAACCTAC
AAAAAAAAGTACAATGAAGCCAGT	TCACCTCAGATTCCTT
AAAAAAAAGTGAACCGAAGCCAGT	TCACCTCAGCAAACCT
AAAAAAAACTGCCAGTGCTGAATC	TCACCTGGTAACGGGA
AAAAAAAACTCAGGCTGCTGAATC	TCACCTGGTAATCCCT
AAAAAAAATCTTCATTGCTGAATC	TCACCTGGTGGACATC
AAAAAAAAAATACCTTGCTGAATC	TCACCTGGTTACGCAA
AAAAAAAATCTGTGATGCTGAATC	TCACCTGGTTGACTTC
AAAAAAAAGTCTTGACTGATCCTA	TCACGGATCATGACCG
AAAAAAAACCATGACCTGATCCTA	TCACGGATCATGCAAC
AAAAAAAAAGGGTTGCTGATCCTA	TCACGGATCTATTGTC
AAAAAAAAGGCCAGTACGGTTAGT	TCACTGACACCAACCG
AAAAAAAATCTTGCAACGGTTAGT	TCACTGACAGGCTTGT
AAAAAAAATAGAATCACGGTTAGT	TCACTGACAGTAATAG
AAAAAAAACTTAAGAACGGTTAGT	TCACTGACATAATTGC
AAAAAAAACGCATTATGGTTATGT	TCAGCAAGTGGATTAT
AAAAAAAAAGTCAAACTATCCTCC	TCAGCCTTCGACCTGA
AAAAAAAACTACTAACTATCCTCC	TCAGCCTTCTGTTCAT
AAAAAAAATGTGATTCTAACCCGC	TCAGCGATCTTGGACG
AAAAAAAAACCTTTAACGCCTAAA	TCAGGAGCAGATAGAC
AAAAAAAACACATAAACGCCTAAA	TCAGGAGCATGAATCT
AAAAAAAATTACTGCACAATTTCC	TCAGGTCCAGTATGTT
AAAAAAAAATTGGTGACAATTTCC	TCAGGTCCATTGTTGG
AAAAAAAATGTGCGGGAAGCTTGG	TCAGGTTAGTTTCCGC
AAAAAAAAATGATGACTCCTCTCG	TCAGTAATCAGGTCCA
AAAAAAAAGCCAACCCTCCTCTCG	TCAGTAATCCATAATG
AAAAAAAAAACCAGGCTCCTCTCG	TCAGTAATCCGCCAAA
AAAAAAAACAATTTGCTCCTCTCG	TCAGTAATCTAACCTT
AAAAAAAATAGGTAGCTCCTCTCG	TCAGTAATCTAATCTC
AAAAAAAAGTCCTGATGATATTCG	TCAGTGAGTCACCTAT
AAAAAAAACTTCGCTTGATATTCG	TCAGTGAGTTAGGATT
AAAAAAAATCCGTAATGATATTCG	TCAGTGAGTTCACCAT
AAAAAAAACCTGGAAACGTCCATC	TCATAACCAAAGCTAA
AAAAAAAAGGTGAGAACGTCCATC	TCATAACCAACGTGCT
AAAAAAAAAACGCTAACGTCCATC	TCATAACCAAGTAAGC
AAAAAAAAAGTAAGTCTACAACAA	TCATACTTCAATACGC
AAAAAAAACTCATAACTACAACAA	TCATACTTCATCCTGC
AAAAAAAAGTCAATCCTACAACAA	TCATACTTCGCTATAA
AAAAAAAACCCTAAGCTACAACAA	TCATACTTCTCAATTC
AAAAAAAACAGTAAGCTAACAGGC	TCATCCATCACAGACT
AAAAAAAAGGAATATCTAACAGGC	TCATCCATCCAAACAC
AAAAAAAAACCATTATGTGACCCG	TCATGAGGTTTATCTG
AAAAAAAACTTAGGCCTTCAGGAA	TCATGCCTCAATCTCT
AAAAAAAATGTGTTACTTCAGGAA	TCATGCCTCACAGCCA
AAAAAAAACATAATCCTTCAGGAA	TCATGCCTCACGAATC
AAAAAAAACGGAGCACTTCAGGAA	TCATGCCTCCTAGTAA
AAAAAAAAATAGCCTCTTAGGAGT	TCATGTTTCACGCGGT
AAAAAAAAAGTCAAACTTAGGAGT	TCATGTTTCGACCTGA
AAAAAAAAGTAGCTTCTTAGGAGT	TCATGTTTCTTCAATC
AAAAAAAACATGGTCCTACTGGCC	TCATTACTCATTACAG
AAAAAAAACTATAACCTACTGGCC	TCATTACTCATTGCAA
AAAAAAAATGCGTGTCTACTGGCC	TCATTACTCCTGGTGA
AAAAAAAAACAAGGCCTACTGGCC	TCATTACTCGATAACC
AAAAAAAATCTCAAACTACTGGCC	TCATTACTCTGCAAGT
AAAAAAAACCTGCTCCTACTGGCC	TCATTACTCTTGACCC
AAAAAAAAGGAACATTGTCCTTAT	TCATTGCGTCCTAGTT
AAAAAAAAATTGGGATGCTTGCGG	TCATTTGGTTGCGGAT
AAAAAAAAGCGGTCAACCTCCTCT	TCCACAACAACCGCCA
AAAAAAAACTATTAGCTTGAGCAA	TCCAGGATCCAAGTTA
AAAAAAAATGATTTGCTTGAGCAA	TCCAGGATCGTTAAGC
AAAAAAAACAAGTCCCTTGAGCAA	TCCAGGATCGTTACTT
AAAAAAAACTGCTCCCTTGAGCAA	TCCAGGATCTCACTAT
AAAAAAAAAACGGTTACCTCGACC	TCCAGGTCAATGCCTA
AAAAAAAATCCGGAAACCTCGACC	TCCAGGTCACATAACT
AAAAAAAATAACCGGACCTCGACC	TCCAGGTCACGTAAGG
AAAAAAAATCGACAAGATTCATTG	TCCATAAAGGAGGCAT
AAAAAAAAGCTCATTGATTCATTG	TCCATAAAGGTAGCTT
AAAAAAAACAAGCTCCTTACTTCC	TCCATATTCCATAAGC
AAAAAAAACGATAAGCTTACTTCC	TCCATATTCCCATAGG
AAAAAAAACTATATGCTTACTTCC	TCCATATTCCCTGATC
AAAAAAAAAGTTGTCCTCTATATG	TCCATCATCAATTACG
AAAAAAAAGCGCATCCTCTATATG	TCCATCATCTAATCCT
AAAAAAAAAGGTGCACTCAAGGTA	TCCATGCTCAGGTTTA
AAAAAAAACTTAGCGCTCAAGGTA	TCCATGCTCTCCTCAA
AAAAAAAAAACGTAACTTAGCTAT	TCCATTGTCGGTAACT
AAAAAAAAGCTATTGCTTAGCTAT	TCCATTGTCTAAGTGC
AAAAAAAATGTTGCGCTTAGCTAT	TCCATTGTCTAGCGTG
AAAAAAAAACCCGGAACGTTACTT	TCCCGGACAACCCTAA
AAAAAAAAGATTTGGACGTTACTT	TCCCGGACAATTAGCT
AAAAAAAAATTCATCACGTTACTT	TCCCGGACACGCAACT
AAAAAAAAAGTAGAGGAGTCAAGC	TCCCGTTAGGAGTAAT
AAAAAAAATTTGTACGAGTCAAGC	TCCCGTTAGTTGTCCC
AAAAAAAAAAGATAGACATGATCG	TCCCTCACAGCTTAGC
AAAAAAAAAGCTCAAACATGATCG	TCCCTCACATCGCTCC
AAAAAAAACGCTATGCTGGCTATT	TCCCTGGTCCACCTTA
AAAAAAAACTATTGACTGGCTATT	TCCCTGGTCCTAAGAC
AAAAAAAATGCTGTGCTGGCTATT	TCCCTGGTCCTGATTT
AAAAAAAACTATTGACTATGGCTT	TCCGCCATCCTAAGAC
AAAAAAAAACCAATCCTATGGCTT	TCCGCCATCGCTTCTA
AAAAAAAAGTTAACCCTAAGGACC	TCCGGTTTCATTACTC
AAAAAAAATTTAAGCCTAAGGACC	TCCGGTTTCTTGAGGT
AAAAAAAACTTCATTTGCTCCTAC	TCCTAGTGTCCCGGAA
AAAAAAAACAATGAATGCTCCTAC	TCCTAGTGTGATGGCT
AAAAAAAACTGCTAATGCTCCTAC	TCCTAGTGTTACAAAC
AAAAAAAATGCTTGATGCTCCTAC	TCCTAGTGTTGGTGAC
AAAAAAAATGCGGGACTCTATTGA	TCCTCAATCACACAGT
AAAAAAAAATAATGCGAATCGCTT	TCCTCTAAGCAAGACA
AAAAAAAATCGACAAGAATCGCTT	TCCTCTAAGGAGGCAT
AAAAAAAACTAGTTTGAATCGCTT	TCCTCTAAGGTGCTGC
AAAAAAAACACCAACCTTCCTGAG	TCCTGGTTCAATGTGC
AAAAAAAAGGCTAAGCTTCCTGAG	TCCTGGTTCATCAGTA
AAAAAAAAGGCGGTTACTAGTCTC	TCCTGTTCAAGGACCA
AAAAAAAATACTCACACTAGTCTC	TCCTGTTCATCCCGCT
AAAAAAAACGGCTATCTCCAACCA	TCCTTAGTCCTCCATA
AAAAAAAACGCAAGCGACAACATG	TCCTTCAAGACTTACA
AAAAAAAAGCCCAAAGACAACATG	TCCTTCAAGCCGCAAC
AAAAAAAACCAAGGTACTCACACT	TCCTTTACACAGCCAT
AAAAAAAACAGCGATACTCACACT	TCCTTTACACCTAAGC
AAAAAAAACCTCCTCGAAACCGTG	TCGATTAAGGACAATG
AAAAAAAAGGTAACCGAAACCGTG	TCGATTAAGTAAGGGC
AAAAAAAATCCACCTTGCGTGTTA	TCGCATTGTAAGGTTT
AAAAAAAAAGTTGCCTGCGTGTTA	TCGCATTGTAGCCTAA
AAAAAAAAGACGTAATGCGTGTTA	TCGCATTGTTCCTGAT
AAAAAAAATACAACCTGCGTGTTA	TCGCATTGTTTGTCTA
AAAAAAAAACCGCCACTGGCATGA	TCGCCCATCATGTGGT
AAAAAAAATTGCATCACGCTAATG	TCGCGCACAAGTGTTT
AAAAAAAAGGTTACAACGCTAATG	TCGCGCACAATACTGT
AAAAAAAACGCATCCACGATTACG	TCGCTAACAGTAGGAT
AAAAAAAACTAGTCTACGATTACG	TCGCTAACAGTTTACG
AAAAAAAACTTAAGAACGATTACG	TCGCTAACATAATTGC
AAAAAAAAGTCCTCCTGCTCAGGC	TCGGTAAGTCACAAAT
AAAAAAAAACCCTCCTGCTCAGGC	TCGGTAAGTGGAAACG
AAAAAAAAATGAGAAACAGAATGA	TCGGTTACACAATACT
AAAAAAAAGCGGTGTACAGAATGA	TCGGTTACACCTGCTC
AAAAAAAAATATCGCCTTTGAGGA	TCGGTTCTCATAAGCC
AAAAAAAATTGTTGACTTTGAGGA	TCGGTTCTCTGGTCCT
AAAAAAAAAGTAGCGCTTTGAGGA	TCGGTTCTCTTAGGAC
AAAAAAAAGATGACATGAGCGAAT	TCGGTTTGTAATAACC
AAAAAAAATATTGGCTGAGCGAAT	TCGGTTTGTCACAGAC
AAAAAAAAGCTCCCTTGAGCGAAT	TCGGTTTGTCTCACTG
AAAAAAAATCTGTGATGAGCGAAT	TCGGTTTGTTGACTTC
AAAAAAAATCCCTCTACCCTTCTC	TCGTAATCAATCATGT
AAAAAAAATAACCGGACCCTTCTC	TCGTAATCACGTAAGG
AAAAAAAACTAACCTACCCTTCTC	TCGTAATCATGATTGT
AAAAAAAAGAGAAGCACCCTTCTC	TCGTAATCATGTGGGA
AAAAAAAATAGAATCACCGCCACT	TCGTCAACAGTAATAG
AAAAAAAACCACTATACCGCCACT	TCGTCAACAGTCTAGC
AAAAAAAAATGCTTTACCGCCACT	TCGTCAACATCACTTC
AAAAAAAATTACCCAACCGCCACT	TCGTCAACATTATGAC
AAAAAAAACGGCTATCTCACAACC	TCGTGCTTCCTCCATA
AAAAAAAATCATGGAGAACCTGGA	TCGTTAAAGACCATAC
AAAAAAAACTCAAAGGAACCTGGA	TCGTTAAAGGAAGCTA
AAAAAAAAACCACGTTGGCTTTCT	TCGTTACGTAATCACG
AAAAAAAATCATTTCTGGCTTTCT	TCGTTACGTCCTTTAA
AAAAAAAACAGATTCTGGCTTTCT	TCGTTACGTCTTGCAT
AAAAAAAAGCGGTAACTACAAACA	TCGTTATTCATGGTTA
AAAAAAAATAACCGGACGTTTCCG	TCGTTTCCACGTAAGG
AAAAAAAAAGAAATGACGTTTCCG	TCGTTTCCACTTAGGC
AAAAAAAAGGGCATGTGCATCCCT	TCTAACCGTTAGCAGC
AAAAAAAATGATTTGCTGGACCAA	TCTAACTTCGTTAAGC
AAAAAAAATCGATCATGGATGCAA	TCTAAGGGTCCACAAA
AAAAAAAAGGTAATGTGGATGCAA	TCTAAGGGTCGCAATA
AAAAAAAAGCTTGTGTGGATGCAA	TCTAAGGGTTGAAGCC
AAAAAAAATATTCCTTGGATGCAA	TCTAAGGGTTTGCAGA
AAAAAAAATACGTTACTCAATGAG	TCTAATCTCAAACTCA
AAAAAAAAACTCATGCTCAATGAG	TCTAATCTCGTTTCTG
AAAAAAAACGACAAACTCAATGAG	TCTAATCTCTTTAAGG
AAAAAAAATGCTTCAACTTATCGC	TCTACCTCAATAGCCC
AAAAAAAATGAACCGACTTATCGC	TCTACCTCACATACTG
AAAAAAAAATACCGAACTTATCGC	TCTACCTCACCAGCAT
AAAAAAAATAAGGTTACTTATCGC	TCTACCTCACGAATCC
AAAAAAAATGTAATGACTTATCGC	TCTACCTCATTAAAGG
AAAAAAAAGTTCCTTTGTGCGCGT	TCTACTAGTGGTTATG
AAAAAAAAATTGTCATGTGCGCGT	TCTACTAGTTACTAGG
AAAAAAAATGCGCCTACCTTGAGG	TCTAGCACAATATACC
AAAAAAAAACAAACACTGGTCTAT	TCTAGCCTCAGCACCA
AAAAAAAAACGGAACCTGGTCTAT	TCTAGCCTCATCCACC
AAAAAAAAACTAAAGCTGGTCTAT	TCTAGCCTCATTTGCT
AAAAAAAACTTGAAGGATTAGGAC	TCTAGCGAGTAAGAAC
AAAAAAAAATAGCCTCTAAGCTAA	TCTATGTTCACGCGGT
AAAAAAAACTGGATCCTAAGCTAA	TCTATGTTCCTCATCA
AAAAAAAATTCGCGACTAAGCTAA	TCTATGTTCTGTAATG
AAAAAAAAGCTCAATCTAAGCTAA	TCTATGTTCTTAGTCT
AAAAAAAAGTGGCCAACCCAACCC	TCTCAAGCAAGTTATC
AAAAAAAAACTGCAAACCCAACCC	TCTCAAGCAGTTATGT
AAAAAAAAGTCTGGGACCCAACCC	TCTCAAGCATAATGAG
AAAAAAAAGCGATAGCTTATCGCG	TCTCAATTCTAATTGG
AAAAAAAAGATTCAAGAATCACTC	TCTCACCAGGCAAGTA
AAAAAAAAGCTGTGAGAATCACTC	TCTCACCAGGCTGGCT
AAAAAAAACCGATTATGCTTTATC	TCTCCTCGTACCAGGT
AAAAAAAATCGGTATTGCTTTATC	TCTCCTCGTTTAGTCC
AAAAAAAACGACTTGCTTCGCTTT	TCTGGCTTCAAGTGTC
AAAAAAAATTGGCCACTTCGCTTT	TCTGGCTTCCGGTTGA
AAAAAAAATAACCGGACTAATCCC	TCTGTGACACGTAAGG
AAAAAAAACGGCCTTACTAATCCC	TCTGTGACATAAGCAA
AAAAAAAACCCTGTGACTAATCCC	TCTGTGACATGAGTTT
AAAAAAAAGAGAAGCACTAATCCC	TCTGTGACATGTGGGA
AAAAAAAAACGTATTTGGTAAGGT	TCTTAGCGTACCGTTT
AAAAAAAATTGTTGGTGGTAAGGT	TCTTAGCGTAGGTTTG
AAAAAAAAGAGCTGGTGGTAAGGT	TCTTAGCGTGCATTTC
AAAAAAAATTATTCCTGGTAAGGT	TCTTAGCGTGCTTTAC
AAAAAAAACTTGAATCTACGGATG	TCTTAGTTCCCGCAAA
AAAAAAAAAGAACCGCTACGGATG	TCTTAGTTCTCACACC
AAAAAAAACCTTACCTGAATCGAG	TCTTCAAGTTCATCTA
AAAAAAAATATTCCTTGAATCGAG	TCTTCAAGTTTGCAGA
AAAAAAAAGAAGAAATGTGGCTTA	TCTTGACGTACGTTTC
AAAAAAAAGCTACAAACATAAAGG	TCTTGTCCAGGCTACT
AAAAAAAATCTTAGTGATCCTTTC	TCTTTGTAGCAATAGG
AAAAAAAAGCCTATTGATCCTTTC	TCTTTGTAGCGCAATT
AAAAAAAAGTCAATAGATCCTTTC	TCTTTGTAGCGCCTTT
AAAAAAAAAAAGTGAACGATTCAG	TGAACAACATTTAAGC
AAAAAAAATTTCCGGGAAGTCAGC	TGAACAGAGCCAGTAT
AAAAAAAATAGACCAGAAGTCAGC	TGAACAGAGCCTTAAA
AAAAAAAAACCGCCACTTGAGGGC	TGAAGGATCATGTGGT
AAAAAAAAGCCTGGTCTTGAGGGC	TGAAGGATCCGCAAAT
AAAAAAAATTTCAAGCTTGAGGGC	TGAAGGATCCTAATTC
AAAAAAAAGGTTATCCTTGAGGGC	TGAAGGATCGTTATAG
AAAAAAAAATTTCGCGATGGAGGA	TGAAGTGAGCAAGGAC
AAAAAAAAGAAGTGAGATGGAGGA	TGAAGTGAGTGATTCA
AAAAAAAAGCAGTAATGTTTACGG	TGACCTTGTATTGGAT
AAAAAAAAACTAGGATGTTTACGG	TGACCTTGTGTTTGCT
AAAAAAAACGATTCATGTTTACGG	TGACCTTGTTACCTGT
AAAAAAAACGCTAGCTGTTTACGG	TGACCTTGTTGGTTAG
AAAAAAAAGGCATGACTTAGCCAC	TGACTCCTCCAGGTTG
AAAAAAAACCTGCTCCTTAGCCAC	TGACTCCTCTTGACCC
AAAAAAAACGAGTTAGAATCGTTC	TGACTTAAGCACGATT
AAAAAAAAAGCGAGGGAATCGTTC	TGACTTAAGGTAAGGC
AAAAAAAATCGATCATGTGGCCCA	TGACTTCGTCCACAAA
AAAAAAAACTTCGCTTGTGGCCCA	TGACTTCGTTAGGATT
AAAAAAAAGAGGTGAACGCTTAAG	TGAGAACCACACTAAT
AAAAAAAACAAGGTCACGCTTAAG	TGAGAACCACTTACAG
AAAAAAAACTGGTTTACGCTTAAG	TGAGAACCAGCCTAAC
AAAAAAAAAAGATAGACGCTTAAG	TGAGAACCAGCTTAGC
AAAAAAAATAATCCTGATGCGATA	TGAGCAAAGGCGCATC
AAAAAAAAACCTAAAGATGGCGCA	TGAGCTTAGCTTCTCA
AAAAAAAACTCAAAGGATGGCGCA	TGAGCTTAGGAAGCTA
AAAAAAAAAATGAGGGATGGCGCA	TGAGCTTAGTAGCCAT
AAAAAAAAGTAATCGACCTTGCTA	TGAGGCACAACAGCCT
AAAAAAAACCGGTAAACCTTGCTA	TGAGGCACAAGCCACT
AAAAAAAATGAACCGACCTTGCTA	TGAGGCACACATACTG
AAAAAAAATACAACAACTGTCAGG	TGAGGGCCAACTAGCC
AAAAAAAATGCGTGAACTGTCAGG	TGAGGGCCACATTAAC
AAAAAAAAGGGAGTAACTGTCAGG	TGAGGGCCAGCATGAG
AAAAAAAATCCCTCTACCGCAAAC	TGAGGTGCAATCATGT
AAAAAAAAGAGAGCAACCGCAAAC	TGAGGTGCAGGACCTT
AAAAAAAACTATTGTGACAAATGC	TGAGTGAAGACTAAGG
AAAAAAAAAAATTGCGACAAATGC	TGAGTGAAGTTATCTC
AAAAAAAAGCGGTCAACTTAGGAT	TGAGTTTCAACCGCCA
AAAAAAAATCGGTTTACTTAGGAT	TGAGTTTCACAGGGAC
AAAAAAAATGAACCGACTTAGGAT	TGAGTTTCACATACTG
AAAAAAAATAGAATCACTTAGGAT	TGAGTTTCAGTAATAG
AAAAAAAAACAAAGAACTTAGGAT	TGAGTTTCATAATCGT
AAAAAAAACATGGTGACTTAGGAT	TGAGTTTCATACCCGG
AAAAAAAACTTACGTACTTAGGAT	TGAGTTTCATCCGTAA
AAAAAAAACCGTTAGCTCAAAGAC	TGATCAATCACAAGCT
AAAAAAAACCTTGTTCTCAAAGAC	TGATCAATCATCCTCA
AAAAAAAAACTGAATGACGTAATG	TGATCACAGCTTCCCG
AAAAAAAACTGATTTGACGTAATG	TGATCACAGCTTTGTT
AAAAAAAACGTAATGGACGTAATG	TGATCACAGTTACTTC
AAAAAAAACTACTGATGGGTGAGC	TGATCAGGTTACTTGC
AAAAAAAAGCCATCATGCCGGTAC	TGATCGAGTAGTAAGA
AAAAAAAACCTTATTTGCCGGTAC	TGATCGAGTTGTTCAC
AAAAAAAAAACGGGAACCATTACC	TGATGAACAACTAACT
AAAAAAAAGTAGCTAACCATTACC	TGATGAACAAGGTAAC
AAAAAAAATTTGTGCACCATTACC	TGATGAACATAGGCGA
AAAAAAAAGAAAGGCACCATTACC	TGATGAACATCCAGGT
AAAAAAAAGCTGGTGACCATTACC	TGATGAACATGCTATG
AAAAAAAAGATAATGCTCATCACG	TGATGACTCACAGGAA
AAAAAAAAAGGTGCACTCATCACG	TGATGACTCAGGTTTA
AAAAAAAATAGCGAGTGGCTCATG	TGATGATGTACTTAGG
AAAAAAAATTAGCCATGGCTCATG	TGATGATGTGCATCGG
AAAAAAAAGTCGAGGTGGCTCATG	TGATGATGTTAATGCG
AAAAAAAATTAAGGATGGCTCATG	TGATGATGTTGGATCA
AAAAAAAACGTGAAACTATTCAGC	TGATTAGTCAAGGACA
AAAAAAAATGCGTGTCTATTCAGC	TGATTAGTCCTGGTGA
AAAAAAAAGTGAACCGAGCCACCT	TGATTCAAGCAAACCT
AAAAAAAATAGCTGAGAGCCACCT	TGATTCAAGTCCTTCA
AAAAAAAACCATTATGAGTTTGTC	TGATTGCAGATAGACG
AAAAAAAAGCATAGCGAGTTTGTC	TGATTGCAGGAGGGTT
AAAAAAAAAGAGGCGGAGTTTGTC	TGATTGCAGGCCTAAT
AAAAAAAACGGCAAGCTTTAGCTA	TGCAATATCCAAATCA
AAAAAAAAACTAAGACTTTAGCTA	TGCAATATCTTAGCCC
AAAAAAAATTTAAGCCTTTAGCTA	TGCAATATCTTGAGGT
AAAAAAAAAACCATGACGTGCTGG	TGCACACCAAACGCGA
AAAAAAAACGATATAACGTGCTGG	TGCACACCAATTTAGC
AAAAAAAATTGGACCCTTAAAGCG	TGCATCCTCCGGTTAG
AAAAAAAAATAGCTCCTTAAAGCG	TGCATCCTCCTTAATC
AAAAAAAACCGATTATGCGACTTA	TGCATGAGTACCAGGT
AAAAAAAAAGTTGCCTGCGACTTA	TGCATGAGTAGCCTAA
AAAAAAAACGTCCTTTGCGACTTA	TGCATGAGTCGTTACT
AAAAAAAACTGACATTGCGACTTA	TGCATGAGTTGGATAT
AAAAAAAAATTGGCCTGCGACTTA	TGCATGAGTTTCCACG
AAAAAAAACTAACCATGTGGGTGA	TGCCATTGTCCGTGAG
AAAAAAAATAAGCCTTGTGGGTGA	TGCCATTGTTCATTTG
AAAAAAAAAGCCAAATGTGGGTGA	TGCCATTGTTCTTTAG
AAAAAAAATCCACCTTGTAACGGG	TGCGCAGGTAAGGTTT
AAAAAAAATTGGTAAACAATGTCG	TGCGGTTCACTAAATC
AAAAAAAATAGCACAGACTCAATT	TGCTAACAGGACCAGG
AAAAAAAAGACTAATGACTCAATT	TGCTAACAGGCTAAGA
AAAAAAAAGGATCCAGACTCAATT	TGCTAACAGTGAACGA
AAAAAAAACTCATTGACATCCAGA	TGCTAGCCAAATACCT
AAAAAAAACAGGAGGACATCCAGA	TGCTAGCCAAGGGTTG
AAAAAAAATCACGTTACATCCAGA	TGCTAGCCAATCCCTT
AAAAAAAATGCCAGAACGCGCAAC	TGCTATGCAGCAACCT
AAAAAAAAATGGAGGACAGTAAAG	TGCTCAACAAACCTTG
AAAAAAAAGATTGCAACAGTAAAG	TGCTCAACAATTAAGG
AAAAAAAATAAGGTTACAGTAAAG	TGCTCAACACGAATCC
AAAAAAAATTCCGGCACAGTAAAG	TGCTCAACATATTGAC
AAAAAAAACCTGCAACTACGCCAC	TGCTCCGTCATTGACA
AAAAAAAACCAATATCTACGCCAC	TGCTCCGTCCTAATGA
AAAAAAAAGTGGCTAGATTAGTTC	TGCTCTCAGAGGAGGA
AAAAAAAAATAGACTGATTAGTTC	TGCTCTCAGCCAGGTC
AAAAAAAATAGCACAGATTAGTTC	TGCTCTCAGGACCAGG
AAAAAAAATCTATGTGATTAGTTC	TGCTCTCAGGGTGAGT
AAAAAAAACGTAATGGATTAGTTC	TGCTCTCAGTTACTTC
AAAAAAAAACATTAGGATTAGTTC	TGCTCTCAGTTCCCGT
AAAAAAAACATAGCCCTCAAGACA	TGCTGGATCATTGTCT
AAAAAAAAGATACTCCTCAAGACA	TGCTGGATCCGCAACA
AAAAAAAAACCGGCTCTCAAGACA	TGCTGGATCGCTTGCT
AAAAAAAAAACCCTTGACTGATGA	TGCTTAAAGCGATAGA
AAAAAAAACACCAAAGACTGATGA	TGCTTAAAGTCAATTG
AAAAAAAATGTGTTACTACGCCCA	TGCTTCATCACAGCCA
AAAAAAAACTGGATCCTACGCCCA	TGCTTCATCCTCATCA
AAAAAAAAAGAAAGGCTACGCCCA	TGCTTCATCTCACTCA
AAAAAAAAGGATTGGCTTAACAGG	TGCTTGCTCAGTGAAG
AAAAAAAAGGCTTTACTTAACAGG	TGCTTGCTCCTCAGCT
AAAAAAAAGGGTAATTGGCTTTGG	TGCTTGTGTTCAAGAT
AAAAAAAATGACAAATGGCTTTGG	TGCTTGTGTTTAACGG
AAAAAAAAAAGAACCTGTAGCCAT	TGCTTTAGTAATGGAA
AAAAAAAAGAAGTCATGTAGCCAT	TGCTTTAGTCAAACTG
AAAAAAAATAGCGGATGTAGCCAT	TGCTTTAGTCAAGTGC
AAAAAAAAATGCGCTTGTAGCCAT	TGCTTTAGTTCCAGGG
AAAAAAAATCGATCATGTTCACTT	TGGACTAGTCCACAAA
AAAAAAAAGAGCTGGTGTTCACTT	TGGACTAGTGCATTTC
AAAAAAAATATTACCGATACTTAC	TGGATTCAGCTCAAAC
AAAAAAAAAGCTAATGATACTTAC	TGGATTCAGTGGACAA
AAAAAAAACCTTACCTGCATGTTG	TGGATTGGTTCATCTA
AAAAAAAATCGGTATTGCATGTTG	TGGATTGGTTTAGTCC
AAAAAAAACCTTGTTCTGGTTAGG	TGGCCAATCATCCTCA
AAAAAAAAGTGGCCAACTCAATAG	TGGCCATCAAGTTATC
AAAAAAAAGATTGCAACTCAATAG	TGGCCATCAATTAAGG
AAAAAAAATATGACAACTCAATAG	TGGCCATCAATTATGC
AAAAAAAATTGCAGGACTCAATAG	TGGCCATCAATTGAGA
AAAAAAAAGTTGTCCACTCAATAG	TGGCCATCAGCGCTTG
AAAAAAAAAGCTCAAACTCAATAG	TGGCCATCATCGCTCC
AAAAAAAAGGCATTTCTCCGCAAT	TGGCCTTTCATTAGTG
AAAAAAAACGCAGGACTCCGCAAT	TGGCCTTTCGGCTAGC
AAAAAAAAGCGCATCCTCAAACCC	TGGCGGTTCTAATCCT
AAAAAAAATCCACCTTGCTGGAAG	TGGCTAAGTAAGGTTT
AAAAAAAAGAAGAAATGCTGGAAG	TGGCTAAGTACGTTTC
AAAAAAAATACCTGATGCTGGAAG	TGGCTAAGTCCGTAGG
AAAAAAAATTGAGCTTGCTGGAAG	TGGCTAAGTGAGGTGA
AAAAAAAAGGGATATTGCTGGAAG	TGGCTAAGTGGGTACT
AAAAAAAAAAGTGAGGAAAGGACA	TGGCTATAGACAAGTG
AAAAAAAATAGACCAGAAAGGACA	TGGCTATAGCCTTAAA
AAAAAAAAGATTCAAGAAAGGACA	TGGCTATAGGCAAGTA
AAAAAAAAAGTCATTTGATGAGGT	TGGCTTTGTATGTGGC
AAAAAAAACAATACCTGATGAGGT	TGGCTTTGTCAGGAAG
AAAAAAAAATGTTGTTGATGAGGT	TGGCTTTGTTACATCC
AAAAAAAATTACGGTTGATGAGGT	TGGCTTTGTTGCAATG
AAAAAAAACCGATTATGTTGTGGT	TGGGCATGTACCAGGT
AAAAAAAATCCTAAGTGTTGTGGT	TGGGCATGTTAACGGC
AAAAAAAAGCTAAATGAAGTTATG	TGGGCCTAGATAACCC
AAAAAAAATAGACCAGAAGTTATG	TGGGCCTAGCCTTAAA
AAAAAAAAGTCACAGGAAGTTATG	TGGGCCTAGGACGTAA
AAAAAAAACTCTATGACCCTCCTT	TGGTAAACACACCAAC
AAAAAAAACTAACCTACCCTCCTT	TGGTAAACATGATTGT
AAAAAAAATGTAATGACCCTCCTT	TGGTAAACATTAAAGG
AAAAAAAACCAGGCTTGCTAGAAA	TGGTCAAGTCATGCAA
AAAAAAAAGCTGAGGTGCTAGAAA	TGGTCAAGTGAAGCCT
AAAAAAAAAATACCTTGCTAGAAA	TGGTCAAGTTACGCAA
AAAAAAAATGGCTATTGCTAGAAA	TGGTCAAGTTCACTGT
AAAAAAAAGCGTCTATGCTAGAAA	TGGTCAAGTTTGAGCA
AAAAAAAACGACTTGCTTGGTCCA	TGGTCAGTCAAGTGTC
AAAAAAAATTGCTCTCTTGGTCCA	TGGTCAGTCACATTGA
AAAAAAAAAGTCGAGCTTGGTCCA	TGGTCAGTCATGCTAA
AAAAAAAACAACAAGCTTGGTCCA	TGGTCAGTCCCTTGCG
AAAAAAAACTTGTTCCTTGGTCCA	TGGTCAGTCGATTATG
AAAAAAAATGTGCACCTTGGTCCA	TGGTCAGTCGCTAAAC
AAAAAAAATCTTAGTGAAGTAGCC	TGGTCATAGCAATAGG
AAAAAAAAATTAGTGGAAGTAGCC	TGGTCATAGGACCTTG
AAAAAAAAAGCTAGCGAAGTAGCC	TGGTCATAGGCGCTAC
AAAAAAAAGGCTTCGCTTAACCGC	TGGTCCTTCCTAGTCC
AAAAAAAAGTTAACCCTTGATGTT	TGGTGCATCATTACTC
AAAAAAAAGACTTACCTTGATGTT	TGGTGCATCCACCTGT
AAAAAAAAGCCTGGTCTTGATGTT	TGGTGCATCCGCAAAT
AAAAAAAAAAGGAAGCTAAGTCCT	TGGTTAATCTTGCAGG
AAAAAAAAGTAGCTTCTAGAAACT	TGGTTCCTCTTCAATC
AAAAAAAAGCTGTCATGTTGCAGT	TGGTTCTGTCAAGTAT
AAAAAAAAAAATCCTTGTTGCAGT	TGGTTCTGTGTTTCAC
AAAAAAAACATAAGTACGTGCAAT	TGTAACTCAAATTCGT
AAAAAAAAGGCGGTTACGTGCAAT	TGTAACTCAAGGACCA
AAAAAAAACTGGTTTACGTGCAAT	TGTAACTCAGCCTAAC
AAAAAAAATTGGGTTTGCAATGTC	TGTAAGTGTAACAGGG
AAAAAAAATGGGAACTGCAATGTC	TGTAAGTGTACAAAGA
AAAAAAAATGTTAGCTGCAATGTC	TGTAAGTGTTCACCCA
AAAAAAAACCTTATTTGCAATGTC	TGTAAGTGTTGTTCAC
AAAAAAAACTCCCACCTAGATTGA	TGTAATGTCCCTGACT
AAAAAAAAAGGGTTGCTAGATTGA	TGTAATGTCTATTGTC
AAAAAAAACGTCCTTTGGTTTGGC	TGTATCCGTCGTTACT
AAAAAAAACACAGGATGGTTTGGC	TGTATCCGTTATGTGG
AAAAAAAAGGGTAATTGGTTTGGC	TGTATCCGTTCAAGAT
AAAAAAAAGCAATTGACTAATCGA	TGTATCGCATTGACAT
AAAAAAAATCACGTTACTAGGACC	TGTCAATCAATCCCTT
AAAAAAAATGGTGTGACTAGGACC	TGTCAATCACAAAGGT
AAAAAAAAACTTAGGACTAGGACC	TGTCAATCATCATGGC
AAAAAAAACTAACTCACTAGGACC	TGTCAATCATGTCGCG
AAAAAAAACGCTTTAACTAGGACC	TGTCAATCATTGTGTG
AAAAAAAAATGAATCGAGGAGGAC	TGTCAGTAGAACAAGT
AAAAAAAAAAAGCTTGAGGAGGAC	TGTCAGTAGGTACCGC
AAAAAAAACCGTGAGGAGGAGGAC	TGTCAGTAGGTGTCCA
AAAAAAAACGTAATGGAGGAGGAC	TGTCAGTAGTTACTTC
AAAAAAAAGTTGCAGGATCAGGTA	TGTCATAAGGCGAATA
AAAAAAAACTAGTTTGATCAGGTA	TGTCATAAGGTGCTGC
AAAAAAAAGGTTGCAGATCAGGTA	TGTCATAAGTCAGTAC
AAAAAAAATCTTCATTGGTGCTGT	TGTCCTGGTGGACATC
AAAAAAAATCCATAGTGGTGCTGT	TGTCCTGGTGTGTCCC
AAAAAAAACGATCCGTGGTGCTGT	TGTCCTGGTTTAAAGC
AAAAAAAAACCTTGCACCTTAGAA	TGTCCTTCAAGCTTTG
AAAAAAAAACCTTTAACCTTAGAA	TGTCCTTCAGATAGAC
AAAAAAAATTAAAGCACCTTAGAA	TGTCCTTCATAATCCG
AAAAAAAAAGCCGGTACTACGGGT	TGTGAAACACAGACTC
AAAAAAAACACCATTACTACGGGT	TGTGAAACATGCATAT
AAAAAAAAGTGTAATGAAACACTA	TGTGATCAGGATTTGC
AAAAAAAAATGACTTTGGCATGTC	TGTGCAAGTTATCCGT
AAAAAAAATGCTATGTGGCATGTC	TGTGCAAGTTTGGGTA
AAAAAAAAGTCACCATGTTGTCAG	TGTGCGGGTGACATAT
AAAAAAAACTACCGGTGTTGTCAG	TGTGCGGGTGTTAAAC
AAAAAAAAGTTCACCACTTTAAGG	TGTGGAGCAGCTTAAT
AAAAAAAAATTTGGTTGCAATCGT	TGTGGCGGTCAGTAAT
AAAAAAAATTCCGGCACGTAAACC	TGTGGCTCATATTGAC
AAAAAAAAGTGCGAGTGCAGTAAA	TGTGTGAGTATTGAGT
AAAAAAAATGCTCTCTGCAGTAAA	TGTGTGAGTTGCTTCG
AAAAAAAAATGAGGAGATATTACC	TGTGTTAAGCATTATG
AAAAAAAATCGTACCGATATTACC	TGTGTTAAGCCAAATC
AAAAAAAAACGGATCGATATTACC	TGTGTTAAGCCACAAT
AAAAAAAATATTACCGATATTACC	TGTGTTAAGCTCAAAC
AAAAAAAACGAGCTGGATATTACC	TGTGTTAAGTATTGCA
AAAAAAAAGTTAGGCGACAAAGCT	TGTTAGCAGCAGGTTT
AAAAAAAAGAATTTGGACAAAGCT	TGTTAGCAGCATTTCT
AAAAAAAAACAGCCAGACAAAGCT	TGTTAGCAGCTAAGTC
AAAAAAAAACATAACGATTGCTAT	TGTTATGAGAACCTGT
AAAAAAAATCCCTTTGATTGCTAT	TGTTATGAGGCATTAC
AAAAAAAACGATTGAGATTGCTAT	TGTTATGAGGTGAAAT
AAAAAAAAATGATGACTAGGCTGA	TGTTCATTCAGGTCCA
AAAAAAAACTTCATGACGTTTACT	TGTTCCTCAGGCCTTG
AAAAAAAAATCCAAGACCTACGGA	TGTTGCACATACTCCT
AAAAAAAAGCAATTGACCTACGGA	TGTTGCACATTGACAT
AAAAAAAAGAATCACACACTTAGG	TGTTGGCCATTGCGTA
AAAAAAAAGGAAGCAACATCCTTA	TGTTGTGCACTAAGTT
AAAAAAAATAACCAAACATCCTTA	TGTTGTGCATGTTGCA
AAAAAAAAAGCCCTTACATCCTTA	TGTTGTGCATTCAGCA
AAAAAAAAGGAGAAACTAGCTGAG	TGTTGTTTCGGTTTCC
AAAAAAAAGTAACACACTCAGTAA	TTAAAGGCAAACAACA
AAAAAAAAGGAGCAAACTCAGTAA	TTAAAGGCACAGGATG
AAAAAAAATAAACGTACTCAGTAA	TTAAAGGCAGCAATAA
AAAAAAAAGGTTAACACTCAGTAA	TTAAAGGCATTATGCG
AAAAAAAATGTTGTTGAGGAACCT	TTAACCAAGACAACAG
AAAAAAAACCCTCCTGAGGAACCT	TTAACCAAGACACCGC
AAAAAAAAATGAGGAGAGGAACCT	TTAACCAAGCATTATG
AAAAAAAAAGGTTACACCGTAATA	TTAAGGACATCAATCG
AAAAAAAACCGATTATGGCGATAA	TTAAGGTGTACCAGGT
AAAAAAAACGCGAAATGGCGATAA	TTAAGGTGTACCTTAC
AAAAAAAACTGACTATGGCGATAA	TTAAGGTGTCCCGAAG
AAAAAAAAGTCGAGGTGGCGATAA	TTAAGGTGTTAATGCG
AAAAAAAAATACCTGCTTAAGGAC	TTAAGTGTCATAACTG
AAAAAAAATTGGCCACTTAAGGAC	TTAAGTGTCCGGTTGA
AAAAAAAACGGAGCACTTAAGGAC	TTAAGTGTCCTAGTAA
AAAAAAAAGGTCCATTGCGTAATC	TTACACCGTCGTAATG
AAAAAAAAACCCTCCTGCGTAATC	TTACACCGTGGAAACG
AAAAAAAAACAGTTAGAATGACTA	TTACAGCAGCACCACA
AAAAAAAACCTTAATGAATGACTA	TTACAGCAGTCATTAG
AAAAAAAAACCACGTTGATGACAG	TTACCGTGTAATCACG
AAAAAAAAGGTCCATTGATGACAG	TTACCGTGTCGTAATG
AAAAAAAACGGCAAGCTAACTGAA	TTACCTGTCCAAATCA
AAAAAAAAAGATTGACTAACTGAA	TTACCTGTCCTCACTA
AAAAAAAAAGTCAAACTAACTGAA	TTACCTGTCGACCTGA
AAAAAAAAACATTGCCTAGGATCG	TTACGTTTCAGAAACG
AAAAAAAAGGTCTATCTAGGATCG	TTACGTTTCGCTCCAT
AAAAAAAAGTGATGGCTAGGATCG	TTACGTTTCTTGCTAT
AAAAAAAAAGCCTCTACGCCACAG	TTAGAAGCAGGATTAA
AAAAAAAAGCTACAAACGCCACAG	TTAGAAGCAGGCTACT
AAAAAAAAATACCGAACTTACTCG	TTAGACTCACCAGCAT
AAAAAAAAATATGCGACTTACTCG	TTAGACTCAGCAAGGC
AAAAAAAACATAATCCTTGAAGTG	TTAGCAATCACGAATC
AAAAAAAATAGGAGTCTTGAAGTG	TTAGCAATCACTAATG
AAAAAAAAGCCAGCTCTTGAAGTG	TTAGCAATCCAGGTCA
AAAAAAAACAGTTATCTTGAAGTG	TTAGCAATCTAAGGAG
AAAAAAAAGCCATGCCTTGAAGTG	TTAGCAATCTCACAAA
AAAAAAAAACCCAACTGGTGAGCG	TTAGCAGGTAATTAGC
AAAAAAAATCCAACATGCTTCCTG	TTAGCCTGTCAAAGAA
AAAAAAAATACCGGCTGCTTCCTG	TTAGCCTGTCGCGCAA
AAAAAAAATCAAACAACGTATTGG	TTAGGAACAGGATGGC
AAAAAAAAGTAGGTTACGTATTGG	TTAGGAACAGGCGAGT
AAAAAAAAACACCAAACGTATTGG	TTAGGAACAGGTTATT
AAAAAAAATTAATGGACGTATTGG	TTAGGAACATTAGCCA
AAAAAAAAAGTAGGTTGGGTTTGC	TTAGGATGTCGCATAA
AAAAAAAAAGCCAAATGGGTTTGC	TTAGGATGTTCTTTAG
AAAAAAAAATGGATTGATTTGAGG	TTAGGCTAGGCCCAGT
AAAAAAAATAGCATGGATAACGTG	TTAGTCAAGCAGCTAT
AAAAAAAACCTAGCTGATAACGTG	TTAGTCAAGGCATGAA
AAAAAAAAGCCAACAGATAACGTG	TTAGTCAAGGTCTTGG
AAAAAAAAAACGATTGATAACGTG	TTAGTCAAGGTTAGAG
AAAAAAAATTCCGGCACATTGACG	TTATAGCCATATTGAC
AAAAAAAAGCCAGCTCTTTCTTGC	TTATCCGTCCAGGTCA
AAAAAAAACCTAACCGATGCATGA	TTATCCTAGGACCTGC
AAAAAAAAGGTCATGGATGCATGA	TTATCCTAGGACTAAG
AAAAAAAACGCTTGTGATGCATGA	TTATCCTAGTAACGGA
AAAAAAAAACGATTAGATGCATGA	TTATCCTAGTGAGCAA
AAAAAAAAACCTCATGATGCATGA	TTATCCTAGTTAGCCG
AAAAAAAAGTTGACGGATGCATGA	TTATCCTAGTTCCTGC
AAAAAAAACTAGTCTACTATGGAT	TTATGACCAGTTTACG
AAAAAAAACATCGTTACCGCACCT	TTATGCGCAACATAAG
AAAAAAAATTACTCCCTCCGTCAA	TTATTGCTCTAGCTTT
AAAAAAAAACGGTTCTGCGCCACA	TTCAACCGTAGCTAAT
AAAAAAAATCTTTGTTGCGCCACA	TTCAACCGTCTCAGCC
AAAAAAAACGGTATTTGCGCCACA	TTCAACCGTGAATCGC
AAAAAAAAACTAGGATGCGCCACA	TTCAACCGTGTTTGCT
AAAAAAAACGATCCGTGCGCCACA	TTCAACCGTTTAAAGC
AAAAAAAAGTCGATTCTAAGTATG	TTCACTGTCATTTGTC
AAAAAAAATAGCTATCTAAGTATG	TTCACTGTCCGGCTAA
AAAAAAAACAGTAATACTTGTTGC	TTCAGCACAAATGCCC
AAAAAAAAGGAAGCAACTTGTTGC	TTCAGCACACTAAGTT
AAAAAAAACACGGATACTTGTTGC	TTCAGCACAGGAATCG
AAAAAAAATAAACCGGACATTACT	TTCAGGTAGCAGGCCT
AAAAAAAAGGTCATGGACATTACT	TTCAGGTAGGACTAAG
AAAAAAAAGCCGATAGACATTACT	TTCAGGTAGTAACGAG
AAAAAAAAACCTCATGACATTACT	TTCAGGTAGTTAGCCG
AAAAAAAACCTTGAGCTTTATCCC	TTCAGTTTCATAATCG
AAAAAAAAGATATAGCTTTATCCC	TTCAGTTTCATTAGCA
AAAAAAAAGTTGTTGCTTTATCCC	TTCAGTTTCGTTCACC
AAAAAAAACGTTTGTACCTCTAAC	TTCATCCCACAAAGCG
AAAAAAAATCATGGAGATAATGGC	TTCATTCAGACCATAC
AAAAAAAATGGTCCTGATAATGGC	TTCATTCAGGCAACAA
AAAAAAAACCCGAAGGATAATGGC	TTCATTCAGGCATTGT
AAAAAAAAGCAGTAATGGTGAGGC	TTCCACGGTATTGGAT
AAAAAAAAGTACTTCGACATAAGC	TTCCCACAGAGGATAT
AAAAAAAATCGACCTGACATAAGC	TTCCCACAGGATCCGC
AAAAAAAAAACGCTAACAGGAAAT	TTCCCGCCAAGTAAGC
AAAAAAAAGAGGAACACAGGAAAT	TTCCCGCCACCACAAC
AAAAAAAAAATCGTGACAGGAAAT	TTCCCGCCAGTTTCTC
AAAAAAAAGGTTGGTGACCTAGCT	TTCCTCAAGAAGGTGC
AAAAAAAAAAACCATGACCTAGCT	TTCCTCAAGATAAAGC
AAAAAAAACCACAGGGACCTAGCT	TTCCTCAAGCTCATAA
AAAAAAAATCCGGTTGACCTAGCT	TTCCTCAAGTGCTGTG
AAAAAAAATGCGGGACTGTTAACC	TTCCTTCTCACACAGT
AAAAAAAATGGAGCGCTGTTAACC	TTCCTTCTCCGTAAAC
AAAAAAAACACTAAGGAAGGATTT	TTCCTTGAGTTCCTCA
AAAAAAAAGTGCGTGACCTTACTG	TTCGCAACAGGTCCTG
AAAAAAAAGACTCAAACCGGCAAT	TTCGGTACAATTTGGT
AAAAAAAACTAACGGACCGGCAAT	TTCGGTACAGGAACTG
AAAAAAAACCCGGTTACCGGCAAT	TTCGGTACAGGCTTCG
AAAAAAAAAGGAAGCACCGGCAAT	TTCGGTACATGTTGGC
AAAAAAAACTACCGCACCGGCAAT	TTCGGTACATTTGCTC
AAAAAAAATGTAGCCCTGATATAG	TTCGTGCTCACAGCGC
AAAAAAAACCAGGTTCTGATATAG	TTCGTGCTCCTCGATC
AAAAAAAAAGTCATTTGGCTATTA	TTCGTTAGTATGTGGC
AAAAAAAACTAGCTATGTGCTGGC	TTCTTAGGTGTCACGG
AAAAAAAAGCAGGCATGTGCTGGC	TTCTTAGGTTCCGGCT
AAAAAAAACTGTTACACCTAGCTT	TTGACATCAACAGGTG
AAAAAAAACCTCCTCGATTCCTGG	TTGACTAAGGACAATG
AAAAAAAACATAACGGATTCCTGG	TTGACTAAGGGACCTC
AAAAAAAATCATGGAGAGAACGAA	TTGAGCTAGACCATAC
AAAAAAAACAACAGCACAAACACC	TTGATGTCAATAACGA
AAAAAAAAAGGATAAACAAACACC	TTGATGTCATGTTTGG
AAAAAAAATCGACAAGATCACATT	TTGCAACAGGAGGCAT
AAAAAAAAGGTAACCGATCACATT	TTGCAACAGTAAGGGC
AAAAAAAACTGACATTGGTTGACC	TTGCAAGGTTGGATAT
AAAAAAAATGAATTGACCTCCCTT	TTGCAATCAATAATGG
AAAAAAAATAGTCAAACCAGTTTC	TTGCACACACATGCTA
AAAAAAAATAACCAAACCAGTTTC	TTGCACACATGTTGCA
AAAAAAAAGCAATTGACCAGTTTC	TTGCACACATTGACAT
AAAAAAAAAGACTCAACCCTGTTA	TTGCAGCCAATGCCCG
AAAAAAAAGATTTGGACCCTGTTA	TTGCAGCCAATTAGCT
AAAAAAAAGTTCACCACCCTGTTA	TTGCAGCCAGCTTAAT
AAAAAAAACTTAAGAACCCTGTTA	TTGCAGCCATAATTGC
AAAAAAAACTCATAACTCGACAAA	TTGCCCGTCATCCTGC
AAAAAAAATGCAGCTCTCGACAAA	TTGCCCGTCCCTCAGT
AAAAAAAAGCCATGCCTAGTGTGG	TTGCGAGTCTCACAAA
AAAAAAAATCGTGACCTGGCAATG	TTGCGTCTCCTAATAG
AAAAAAAATCGGTTTACAGGCATT	TTGCTCTCACAGGGAC
AAAAAAAAAAACCGTACAGGCATT	TTGCTCTCAGCCAGTT
AAAAAAAATAAATGCACAGGCATT	TTGCTCTCAGGCCATT
AAAAAAAAAGGAAGCACAGGCATT	TTGCTCTCATGTTGGC
AAAAAAAAGTCACCATGGGCCATT	TTGCTTAGTGACATAT
AAAAAAAAGAGCTGGTGGGCCATT	TTGCTTAGTGCATTTC
AAAAAAAATGACAAATGGGCCATT	TTGCTTAGTTTAACGG
AAAAAAAAATGACAGTGGGCCATT	TTGCTTAGTTTATGGG
AAAAAAAATACAAGCGAGCTTGAG	TTGCTTTAGCGCTCAA
AAAAAAAATTAGGACGAGCTTGAG	TTGCTTTAGGGTTATC
AAAAAAAAGCTCATTGAGCTTGAG	TTGCTTTAGGTAGCTT
AAAAAAAATGCTTCAACGGTAAGG	TTGGAGGCAATAGCCC
AAAAAAAATAGTCAAACGGTAAGG	TTGGAGGCACATGCTA
AAAAAAAACGCTATGCTTTGTTGA	TTGGATATCCACCTTA
AAAAAAAACGGCTATCTTTGTTGA	TTGGATATCCTCCATA
AAAAAAAAGTAGCTTCTTTGTTGA	TTGGATATCTTCAATC
AAAAAAAATCGATTTGAAGTGAGA	TTGGATCAGCGAAGTA
AAAAAAAAGTACGTAACTAGCTTC	TTGGATTCAATATAGG
AAAAAAAAGCTACTCACTAGCTTC	TTGGATTCACTGACCG
AAAAAAAATTAAGGTACTAGCTTC	TTGGATTCAGTAGGTG
AAAAAAAAGCGCACAACTAGCTTC	TTGGATTCATCAGCAC
AAAAAAAAAGGAAGCACTAGCTTC	TTGGATTCATGTTGGC
AAAAAAAAAATGAGCTGAGGCACG	TTGGCGGGTCCGCTGT
AAAAAAAAATCCGGGACTTTACGC	TTGGCTACATCATGTG
AAAAAAAACATAATGACTTTACGC	TTGGCTACATGGTTAT
AAAAAAAAAGGTTCCTGAAACTGG	TTGGCTTGTTAAGTGT
AAAAAAAACGAGTTAGACTCACAC	TTGGGTTAGCACGATT
AAAAAAAAATGAGGAGACTCACAC	TTGGGTTAGCATTATG
AAAAAAAAGAGAAACGACTCACAC	TTGGGTTAGGAAACTG
AAAAAAAAGATTCCTGACTCACAC	TTGGGTTAGGACCTCA
AAAAAAAAACACCTTGACTCACAC	TTGGGTTAGTTGTCTT
AAAAAAAAAGTAGGTTGGTCCGTA	TTGGTGAGTCGCATAA
AAAAAAAAAGTGAATCTCATTGCG	TTGTAAGTCAAGCCTG
AAAAAAAACACCACACTCATTGCG	TTGTAAGTCACCTGTC
AAAAAAAAAGCTTACCTCATTGCG	TTGTAAGTCCTTGTTG
AAAAAAAAAATTAGGCTCATTGCG	TTGTAAGTCTTGGATA
AAAAAAAAGGCTGATGAGGCTAGT	TTGTCAAAGACAGGTA
AAAAAAAAGCTCAAGGAGGCTAGT	TTGTCAAAGGCTACTG
AAAAAAAATTCAGTACTCAATACT	TTGTCCATCCCTGGTT
AAAAAAAATTACAACCTCAATACT	TTGTCCATCCTGGTCT
AAAAAAAATTATAGCCTCAATACT	TTGTCCATCGTTATCT
AAAAAAAATGATCAGGAGCGCTAA	TTGTCCCAGAATCGCT
AAAAAAAAATGGTTAGAGCGCTAA	TTGTCCCAGGTTAGCT
AAAAAAAATAGCTGAGAGCGCTAA	TTGTCCCAGTCCTTCA
AAAAAAAAGCATATTTGTGCGATT	TTGTCCGGTAAACAAG
AAAAAAAACCTCTGTTGTGCGATT	TTGTCCGGTCGAAGTC
AAAAAAAAACTAACTTGTGCGATT	TTGTCCGGTGTTAGCA
AAAAAAAACGATTCATGTGCGATT	TTGTCCGGTTACCTGT
AAAAAAAAAACTGAGTGTGCGATT	TTGTCCGGTTGCTGGG
AAAAAAAACCTTACCTGAGCAAAC	TTGTGAGGTTCATCTA
AAAAAAAAGCACAAATGAGCAAAC	TTGTGAGGTTGCATCT
AAAAAAAACGACTTGCTGGTTTAC	TTGTGCCTCAAGTGTC
AAAAAAAACAAGTCCCTGGTTTAC	TTGTGCCTCGTTACTT
AAAAAAAAAGCCCTTACATGTTTC	TTGTGTGCATTCAGCA
AAAAAAAATGCTTCAACCTTGAAA	TTGTTCCCAATAGCCC
AAAAAAAAGTGAGGAACCTTGAAA	TTGTTCCCACGTAATT
AAAAAAAAGTGGTTAACCTTGAAA	TTGTTCCCACTCAACA
AAAAAAAAGTGTTTGCTTAACGAG	TTGTTGTTCACCAATA
AAAAAAAACGCCTAACTTAACGAG	TTGTTGTTCCCGCATT
AAAAAAAACCAATATCTTAACGAG	TTGTTGTTCCTAATGA
AAAAAAAAGCGACTCCTTAACGAG	TTGTTGTTCGCTATGG
AAAAAAAAACTAGTTTGCTTGCTC	TTGTTTGGTCTAACCT
AAAAAAAATTGAGGACTTAATGTC	TTTAACCTCAAACACC
AAAAAAAACGGCTATCTTAATGTC	TTTAACCTCCTCCATA
AAAAAAAAACAGAATCTTAATGTC	TTTAACCTCGATATTG
AAAAAAAAGCTTAAAGATGGCTAA	TTTAACGAGGCTACAT
AAAAAAAAATCTAAGGATGGCTAA	TTTAACGAGTCCTTTG
AAAAAAAAGGGTTTGGATGGCTAA	TTTAACGAGTGTTGTA
AAAAAAAACTCTATGACCCTCAAT	TTTAAGCCACACCAAC
AAAAAAAAATCCTTAACCCTCAAT	TTTAAGCCAGCCTTGG
AAAAAAAAAAGTAACCTTGAGGTA	TTTAAGGTCTTGATGA
AAAAAAAAGCTCATTGATTACTTG	TTTACGAAGGTAGCTT
AAAAAAAAGGGCTATGATTACTTG	TTTACGAAGGTGAAGC
AAAAAAAACTAGTTTGATTACTTG	TTTACGAAGGTGCTGC
AAAAAAAATAACGTGGATTACTTG	TTTACGAAGTCAATCA
AAAAAAAACACCAAAGATTACTTG	TTTACGAAGTCAATTG
AAAAAAAACCAGGTGGACTTATTG	TTTAGCAAGACTATTG
AAAAAAAAGCAATAACTCATCAGC	TTTAGCTTCCAGGGAG
AAAAAAAACTAGCCACTCATCAGC	TTTAGCTTCCTGAATA
AAAAAAAAGATAATGCTCCATGAC	TTTAGGATCACAGGAA
AAAAAAAAGCCATGCCTCCATGAC	TTTAGGATCTCACAAA
AAAAAAAACGTTATTGACAGCCAG	TTTATGGAGGCTTAAC
AAAAAAAATATGCTCACTTAGGCG	TTTCACCCAGGGAGCT
AAAAAAAATGCCTTTCTTGTGTTA	TTTCAGTTCGACAAAG
AAAAAAAACTAGACCCTTGTGTTA	TTTCAGTTCTTAGCGG
AAAAAAAATCCCATAACTCAACAA	TTTCCACCAGAAATGC
AAAAAAAATCTAACCACTCAACAA	TTTCCACCAGGCTAAG
AAAAAAAAGTTAGGCGAACAATGT	TTTCCTGAGCAGGTTT
AAAAAAAATCGTACCGAACAATGT	TTTCCTGAGCCAAATC
AAAAAAAACATAGTGGAACAATGT	TTTCCTGAGGGTGAAC
AAAAAAAAGGTTGCAGAACAATGT	TTTCCTGAGTCAGTAC
AAAAAAAACGTAATGGAACAATGT	TTTCCTGAGTTACTTC
AAAAAAAAATGGAGGACTTAGTAG	TTTCGTCCAAACCTTG
AAAAAAAACGAGCTAACTTAGTAG	TTTCGTCCATGACTAT
AAAAAAAACATAAGTACGATTGCA	TTTCTCACAAATTCGT
AAAAAAAAGTCATAGACGATTGCA	TTTCTCACAAGCGATG
AAAAAAAATCGCTATACGATTGCA	TTTCTCACAATGAAGC
AAAAAAAAACCGGACACGATTGCA	TTTCTCACATTAGGCC
AAAAAAAAAGGACTTACTAAAGGG	TTTCTTGCACTTAACG
AAAAAAAAGGTACTAACTAAAGGG	TTTCTTGCAGTCTAAT
AAAAAAAATGGAGCATGCTCACAA	TTTGACCGTCATTGAG
AAAAAAAAGGTCCATTGCTCACAA	TTTGACCGTCGTAATG
AAAAAAAAGTCCTGGCTACCTAGT	TTTGACTTCGCTAGCA
AAAAAAAATATTAGCCTACCTAGT	TTTGACTTCTATCGCC
AAAAAAAAGAGAGCAACTAGCTGG	TTTGAGTCAGGACCTT
AAAAAAAACGAGCTAACTAGCTGG	TTTGAGTCATGACTAT
AAAAAAAAATGTTGCCTATCCGTA	TTTGCATTCCGTCCAT
AAAAAAAAGCACGCAACCTCACAT	TTTGCGACAGCAAATA
AAAAAAAACTAACCTACCTCACAT	TTTGCGACATGATTGT
AAAAAAAATATTGGCTGTAAGTCC	TTTGGCTGTCACAGAC
AAAAAAAAATTAGTGGAGCTATCT	TTTGGTAAGGACCTTG
AAAAAAAAGGAGCTTGAGCTATCT	TTTGGTAAGTCATTTC
AAAAAAAATTACGTCACAAACAAG	TTTGGTGCACAAAGAC
AAAAAAAAGGAAGCAACAAACAAG	TTTGGTGCACTAAGTT
AAAAAAAAAGGACTTACAAACAAG	TTTGGTGCACTTAACG
AAAAAAAAGTAGCTAACAGCAATC	TTTGTCCCAAGGTAAC
AAAAAAAAGGAACCTGAATTGACA	TTTGTCTAGGATTGAG
AAAAAAAACGGATTAGAATTGACA	TTTGTCTAGGTTACGT
AAAAAAAATGCTTATGAATTGACA	TTTGTCTAGTAAACCC
AAAAAAAAGCTATGGGAATTGACA	TTTGTCTAGTAGCTTA
AAAAAAAAACCAGGTGAATTGACA	TTTGTCTAGTTGTCAA
AAAAAAAAATTCCTGGACACCTAC	TTTGTGAAGGTATTGC
AAAAAAAACTTGAAGGACACCTAC	TTTGTGAAGTAAGAAC
AAAAAAAAAGTCACAACACCAAAC	TTTGTGGCAAATATCC
AAAAAAAACAATTGAACACCAAAC	TTTGTGGCAACAACAA
AAAAAAAATATGACAACACCAAAC	TTTGTGGCAATTATGC
AAAAAAAAGAACCGCACACCAAAC	TTTGTGGCAGGAACAT
AAAAAAAAGAGGGAGCTTGAGAAC	TTTGTGTTCATGCTCC
AAAAAAAAGTGAGCACTTGAGAAC	TTTGTGTTCATGTCAA
AAAAAAAATAGCAAGCTTGAGAAC	TTTGTGTTCATTAGGC
AAAAAAAATGGCTCACTTGAGAAC	TTTGTGTTCGATTCTT
AAAAAAAAAAGGAAGCTTGAGAAC	TTTGTGTTCTTGCAGG
AAAAAAAAGTTTAACTGAAGTACG	TTTGTTGGTGATGAGG
AAAAAAAAGACAATGTGAAGTACG	TTTGTTGGTTAACACG
